###########
#...#.....#
#.#.#.###.#
#.#.#.#S..#
#.#.#.#####
#.#.#.....#
#.#.#####.#
#.#.....#.#
#.#####.#.#
#..E..#...#
#####.#####
#.........#
###########
