###########
#.........#
###.#.#.#.#
#.#.#E..#.#
#####.#.###
#...#.....#
#####.#.###
#...#.#...#
#.#.###.#.#
#.#...#.#.#
###.#.#.###
#.#.#..S..#
###.#######
#.#.......#
###########
