###########
#.......#E#
###.###.#.#
#...#.#.#.#
#.###.#.#.#
#S#.#...#.#
###.#.###.#
#...#...#.#
#.#.###.#.#
#.#...#...#
#.###.###.#
#...#...#.#
###.#.###.#
#...#.....#
###########
