###########
#.........#
#####.#.#.#
#...#.#.#.#
#####.#####
#...#....E#
#####.###.#
#...#...#.#
#.###.#####
#...#.....#
#.###.###.#
#...#..S#.#
#.#########
#.........#
###########
