###########
#S#.......#
#.#.#####.#
#.#.#.....#
#.#.#######
#.#..E....#
#.#.#####.#
#.#.....#.#
#.#######.#
#.........#
###########
