###########
#.........#
#.###.###.#
#.#...#...#
#.#.#######
#.#.#....S#
#.#.#.#####
#.#...#...#
#.#####.#.#
#.#.....#.#
#.###.#.###
#E..#.#...#
###.#####.#
#.........#
###########
