###########
#.........#
#.#########
#.#......S#
#.#.#######
#...#E#...#
#.###.#.#.#
#...#...#.#
###.#####.#
#.........#
###########
