###########
#.......#S#
#.#.#####.#
#.#.#.....#
###.#.###.#
#.......#.#
#.#.###.###
#.#.#...#.#
###.#.###.#
#.#.#.....#
#.#####.###
#.....#.#.#
###.###.#.#
#.#...#.#E#
#.#.###.#.#
#.........#
###########
