###########
#.........#
###########
#.........#
#.#.#.#####
#.#.#.....#
#.###.#####
#...#E....#
#######.#.#
#.......#.#
#.###.#.#.#
#...#.#.#.#
#.#####.###
#......S..#
#.#.#.#.#.#
#.#.#.#.#.#
#.#########
#.........#
###########
