###########
#.........#
#.#.#.#.###
#.#E#.#...#
#.#.###.#.#
#.#...#.#.#
#.#.#####.#
#.#.....#.#
###.#.###.#
#.#.#...#.#
#.#.###.###
#.#S..#...#
###.#.###.#
#.#.#...#.#
###.#.###.#
#.#.#...#.#
###########
