###########
#S....#...#
#####.#.###
#.#...#...#
#.#.#####.#
#.#.......#
#.#######.#
#..E..#...#
#.#####.###
#.......#.#
#.#######.#
#.#.....#.#
#.#.###.#.#
#...#.....#
###########
