###########
#.........#
#.#######.#
#.#...#E..#
#.#.#.#####
#...#.#...#
#.###.#.#.#
#.#.#...#.#
#.#.#####.#
#...#...#.#
###.#.#.#.#
#.#.#.#.#.#
#.#.#.#.#.#
#.#.#.#...#
#.#.#.###.#
#...#..S#.#
###########
