###########
#.#...#S..#
#.#.#.###.#
#...#...#.#
#.###.#.#.#
#...#.#.#.#
###.#.#.#.#
#...#.#E#.#
#####.###.#
#.....#...#
#.#####.###
#.........#
###########
