###########
#.#.....#S#
#.#.#.###.#
#.#.#.....#
#.#.#######
#...#.#...#
#.###.#.#.#
#...#...#.#
###.#####.#
#......E..#
###########
