###########
#.........#
###.#.#.#.#
#.#.#.#.#.#
#.###.###.#
#...#S..#.#
#.###.#####
#...#.....#
###.#.#.#.#
#.#.#.#.#.#
###.#.#.#.#
#.#.#.#.#.#
#####.#####
#.........#
#.#.#.#.#.#
#.#..E#.#.#
###########
