###########
#S..#.#...#
###.#.###.#
#.#...#...#
#.#.###.#.#
#..E#...#.#
#.###.###.#
#.#...#.#.#
#.#####.#.#
#.........#
###########
