###########
#.....#S#.#
#.#.###.#.#
#.#.....#.#
#.#######.#
#...#.#.#.#
#.#.#.#.#.#
#.#.......#
#######.###
#......E..#
#.#.#.#####
#.#.#.....#
###.#.#####
#...#...#.#
#.#.###.#.#
#.#.#.....#
###########
