###########
#.........#
#.#.#.#.#.#
#.#.#.#.#.#
###.###.###
#.#..S#...#
###.#.#.#.#
#.#.#.#.#.#
#.#.#.#####
#.#.#.....#
#.###.#.###
#...#.#..E#
###########
