###########
#.....#..E#
#.###.#.#.#
#.#...#.#.#
#.#.###.#.#
#.#.....#.#
#.###.#####
#.#.#.#...#
#.#.#.#.#.#
#.#...#.#S#
#.#####.###
#.........#
###########
