###########
#E#.#.....#
#.#.#.###.#
#.....#.#.#
#.#.###.#.#
#.#.#...#.#
###.#.#.###
#.....#.#.#
###.###.#.#
#...#.#...#
###.#.#.###
#.#.#.....#
#.#.#####.#
#...#...#.#
###.###.#.#
#.....#...#
#.#####.#.#
#.#.....#S#
###########
