###########
#...#.....#
###.#####.#
#......E#.#
#.#.#####.#
#.#.#.#.#.#
###.#.#.#.#
#S#.......#
#.###.###.#
#.......#.#
###########
