###########
#.........#
#.#.#.#####
#.#.#E....#
#########.#
#........S#
#####.###.#
#...#...#.#
#######.###
#.....#...#
#.#########
#.........#
###########
