###########
#.........#
###########
#......E..#
###.#.#####
#...#.....#
###.###.#.#
#..S..#.#.#
###.#.#.#.#
#.#.#.#.#.#
###########
