###########
#.#.#.....#
#.#.#####.#
#.#.#...#.#
#.#.###.#.#
#.......#.#
###.#####.#
#.#.......#
#.#.#.###.#
#...#E#.#.#
#######.#.#
#...#.....#
#.#.#####.#
#.#...#...#
#.###.###.#
#.#.......#
#.#.###.#.#
#.#..S#.#.#
###########
