###########
#E........#
#.###.###.#
#...#...#.#
###.###.#.#
#.#.#.#.#.#
#.#.#.#.#.#
#.#.#.#.#.#
#.#.#.#.###
#.....#...#
#.#######.#
#.#.......#
#.#.#####.#
#.#.#...#.#
#.#.#.#.#.#
#.#...#S#.#
###########
