###########
#.........#
#.###.#####
#...#.....#
#.###.###.#
#...#...#.#
#######.###
#.....#...#
#.#.###.#.#
#.#...#.#.#
#.###.#.#.#
#..S......#
#########.#
#........E#
###########
