###########
#.........#
#####.#.#.#
#...#.#.#.#
#.#.#####.#
#.#.....#.#
#####.###.#
#...#...#.#
#.#.#.#.#.#
#.#....S#.#
###.#.#####
#.#.#.....#
###.#####.#
#.#.....#.#
###.###.#.#
#.#...#.#.#
#.#.#####.#
#..E....#.#
###########
