###########
#.#.......#
#.#.#.#####
#.#.#....S#
#.#.#######
#.#...#...#
#.###.#.#.#
#...#...#.#
#.#######.#
#.......#.#
#.#####.#.#
#...#.#.#.#
###.#.#.#.#
#..E#.#...#
#.###.#####
#...#.....#
###.###.#.#
#.......#.#
###########
