###########
#.........#
#######.#.#
#.....#.#.#
#.#####.#.#
#.....#.#.#
#.#.###.#.#
#......E#.#
#.#.#.###.#
#S#.#...#.#
###########
