###########
#.....#..E#
###.#.###.#
#...#.....#
#######.#.#
#...#...#.#
#.###.#.###
#..S#.#...#
#.#####.###
#...#.#...#
#.###.###.#
#.#.......#
#.#.###.#.#
#...#...#.#
###########
