###########
#.....#S..#
#.###.###.#
#...#.....#
###.#######
#.#...#...#
#.###.###.#
#...#...#.#
#.#.###.#.#
#.#...#...#
#.#######.#
#.....#...#
#.###.#.###
#...#...#.#
###.#####.#
#.#..E#...#
#.###.#.#.#
#.......#.#
###########
