###########
#...#.....#
#.#.#####.#
#.#.......#
#.#######.#
#.#.#.....#
#.#.#.#####
#.#...#...#
#.#.###.#.#
#.#.#S#.#.#
#.###.#.#.#
#...#...#.#
#.#.#####.#
#.#.....#.#
#####.###.#
#.....#...#
#.#####.###
#....E....#
###########
