###########
#.....#...#
#.#####.#.#
#.#.....#.#
#.###.#####
#...#....S#
#.#.#.#####
#.#.#.#.#.#
#.###.#.#.#
#.#.......#
#.#.#######
#....E....#
###########
