###########
#......S#.#
#.#######.#
#.....#...#
#.###.###.#
#...#...#.#
###.#.###.#
#...#...#.#
#.###.###.#
#.#.......#
#.#####.###
#....E#...#
###########
