###########
#........E#
#######.#.#
#...#...#.#
#.#######.#
#.#.....#.#
#.###.###.#
#.....#...#
#.#.#.###.#
#S#.#.....#
###########
