###########
#.........#
#.###.#####
#......E..#
#.###.#.###
#...#.#...#
#.#########
#.........#
#.#.#######
#S#.......#
###########
