###########
#.#.....#.#
#.###.#.#.#
#E..#.#...#
#.#.#.#####
#.#...#...#
#####.#.###
#........S#
#####.#####
#.#.#.....#
#.#.###.###
#.........#
#.#.#.#####
#.#.#.....#
###.#.###.#
#...#.#...#
#.#.#.###.#
#.#.#...#.#
###########
