###########
#...#....S#
###.#.#####
#.....#...#
#####.#.###
#......E#.#
#####.###.#
#...#.#...#
###.#.###.#
#.........#
#.#.###.#.#
#.#...#.#.#
###########
