###########
#.......#.#
###.###.#.#
#S..#.....#
###.###.#.#
#...#...#.#
###.###.#.#
#...#...#.#
#.###.###.#
#.#.....#.#
#.#####.#.#
#...#..E#.#
###.#.###.#
#...#.#...#
###.###.#.#
#.....#.#.#
###########
