###########
#.......#.#
#.#####.#.#
#...#...#.#
###.###.#.#
#.#..S#.#.#
#.#####.#.#
#.....#.#.#
#.###.#.#.#
#.#...#.#.#
#.#.#.#.#.#
#.#.#.#.#.#
#.#.###.#.#
#E#.#...#.#
#.#.#.###.#
#.#.#.....#
#.#.#####.#
#.#.....#.#
#.#.#####.#
#.#.#.....#
#.#.#.#####
#.#.......#
###########
