###########
#.........#
#.###.#.#.#
#.#.#.#.#.#
###.#.#####
#...#.#...#
#.###.#.###
#...#.....#
#.###.#.###
#.....#..S#
###.###.###
#.#.#.....#
#.#.#####.#
#.#.#...#.#
#.#.###.###
#.....#...#
###.#.#.###
#.#.#.....#
#.###.###.#
#.......#.#
###.###.###
#.....#.#.#
#.#####.#.#
#...#.#...#
#.###.#.#.#
#E#...#.#.#
#.#.###.###
#...#.....#
###########
