###########
#.........#
#.#######.#
#...#...#.#
#.#.#.#.###
#.#...#...#
#########.#
#S..#.....#
###.#.#####
#...#.....#
#.#######.#
#.#...#...#
#.#.#.#.#.#
#...#...#.#
#########.#
#.....#...#
#.#####.###
#.....#.#.#
#.###.#.#.#
#E..#.#...#
###.#.###.#
#.#.#.....#
#.#.#######
#.........#
###########
