###########
#.........#
#####.#####
#...#.....#
#.#.#.#####
#.#.#..S..#
#####.#.#.#
#...#...#.#
#.###.#.###
#...#.#...#
#.###.#.#.#
#...#.#.#.#
###.###.#.#
#.#...#.#.#
#####.#.###
#...#.#...#
###.###.#.#
#.#.....#.#
###.###.#.#
#.#....E#.#
###########
