###########
#...#.....#
#.#.#.#####
#S#...#.#.#
#####.#.#.#
#...#.#...#
###.#.###.#
#.........#
#####.#.###
#.#.#.#...#
#.#.#.#.###
#.#...#.#.#
#.#.###.#.#
#...#.#...#
#####.###.#
#.#.......#
#.###.#.#.#
#...#.#.#.#
#.#######.#
#...#.#...#
#.#.#.#.###
#.#.....#.#
#.#.#.###.#
#.#.#E....#
#.#.###.###
#.#.#.....#
#.#.###.###
#.#.#.....#
###########
