###########
#.........#
#.#.###.###
#.#...#...#
###.#.#.###
#.#.#.#...#
#####.#####
#...#.....#
###.#######
#.#.......#
#.#.#.#.###
#.#S......#
#.#.#.###.#
#.#.#.....#
###.#####.#
#.#.......#
#########.#
#.......#.#
#.#.###.#.#
#.#...#...#
###.#.#.#.#
#.#.#.#...#
###.#####.#
#.#.......#
#########.#
#........E#
#.#.#####.#
#.#.....#.#
###########
