###########
#.........#
#.#.#.#####
#.#.#.....#
#.###.#####
#........S#
#.###.#.#.#
#...#.#.#.#
#.###.#.#.#
#...#.#.#.#
#.#####.###
#.....#...#
#.###.#.###
#E..#.#...#
#####.#.###
#...#.#...#
#.###.#####
#...#.....#
#.###.#####
#...#.....#
###.#.###.#
#.#.#...#.#
###.#.#####
#.#.#.....#
#.#.#######
#.#.......#
###########
