###########
#.....#E..#
#.###.###.#
#.#...#...#
#.#.###.#.#
#.#.....#.#
#.#######.#
#.....#...#
#.###.#.###
#.#...#...#
###.#######
#...#.....#
#.###.###.#
#...#...#.#
#.#.###.#.#
#.#.....#.#
#.#######.#
#.....#S#.#
#####.#.#.#
#.....#...#
###########
