###########
#.........#
#.#.#######
#.#.#...#S#
###.#.#.#.#
#...#.#...#
#.###.#####
#...#.....#
#.#.#####.#
#.#...#.#.#
#.#.#.#.#.#
#.#.#...#.#
#.#.#.###.#
#.#.#.#...#
###.#.#.###
#...#.#E#.#
#.#####.#.#
#.#.....#.#
#.#.#####.#
#.........#
###########
