###########
#.......#.#
#.#.#.#.#.#
#.#.#.#.#.#
#.#####.#.#
#.....#.#.#
###.#.#.#.#
#.#.#.#S#.#
#.#.#####.#
#...#.#...#
#.###.#.###
#.#...#...#
#.#.#.###.#
#...#.#.#.#
###.#.#.#.#
#.#.#...#.#
#.#.#####.#
#.#.#...#.#
#.#.#.###.#
#...#E#...#
#.###.#.###
#.........#
###########
