###########
#.#...#...#
#.#.#.#.#.#
#...#.#.#.#
#.###.#.#.#
#.#S#...#.#
###.#.###.#
#...#.#...#
#.#####.#.#
#.....#.#.#
#####.#.#.#
#...#...#.#
#.#.#####.#
#.#...#.#E#
#.###.#.#.#
#...#.#.#.#
###.#.#.#.#
#...#...#.#
#.#####.#.#
#...#...#.#
#.#.#####.#
#.#.......#
###########
