###########
#S#.....#.#
#.#.###.#.#
#...#.#.#.#
#.###.###.#
#.#.#.....#
#.#.#.#.#.#
#.....#.#.#
###.###.#.#
#.....#.#.#
#.#.#.###.#
#.#.#.#...#
###.#######
#.#.#E..#.#
#.#.#.###.#
#.....#.#.#
#.#.#.#.#.#
#.#.#.....#
#.#######.#
#.......#.#
###########
