###########
#.......#.#
#####.#.#.#
#.....#...#
#.#######.#
#.#.#...#.#
#.#.###.#.#
#.#...#...#
###.#.###.#
#...#.#...#
#.###.#.###
#...#...#.#
###.###.#.#
#S#...#...#
#.###.#.###
#...#.#...#
###.###.#.#
#.#.....#.#
#.###.#####
#.........#
#.#####.###
#.#...#.#.#
#.###.#.#.#
#...#E....#
###########
