###########
#.........#
#.#####.###
#.....#...#
###.#.#.###
#.#.#.#...#
#####.#####
#...#.....#
#.#.###.#.#
#.#...#.#.#
#.###.#.#.#
#...#.#.#.#
#.#####.###
#.....#...#
#.#####.#.#
#S....#.#.#
###.#.#.###
#.#.#.#...#
#.#.#.###.#
#...#...#.#
###.###.###
#.....#...#
###.#.#####
#...#.....#
###.#.#####
#..E#.....#
###########
