###########
#..S......#
#.#.#.#.###
#.#.#.#...#
#.#.#.###.#
#.#.#...#.#
###.#.#####
#.#.#..E..#
#########.#
#.......#.#
#.#.#.###.#
#.#.#...#.#
#.#.#.#####
#.#.#.....#
#.#.#.#.#.#
#.#.#.#.#.#
###.#.#.###
#.#.#.#...#
#.#######.#
#.......#.#
###.###.###
#.#...#...#
###########
