###########
#...#.....#
#.#.#####.#
#.#.#.....#
#.#####.#.#
#E......#.#
#######.###
#.........#
#.#.#.#####
#.#.#.....#
#######.###
#...#.....#
#.#.#.#.#.#
#.#.#.#.#.#
#.#####.#.#
#.......#.#
#.#####.#.#
#...#.#.#.#
###.#.#####
#.........#
#.#.#####.#
#.#.....#S#
###########
