###########
#...#.....#
#.#.#####.#
#.#.....#.#
#####.###.#
#.......#.#
###.#.###.#
#...#S#.#.#
#.#####.#.#
#.#...#...#
#.#.#####.#
#.......#.#
#.###.###.#
#...#...#.#
#####.###.#
#.#.#.#...#
#.#.#.#.#.#
#.......#.#
#.#.#######
#.#..E....#
###.#####.#
#.#.#.....#
#.#.#.#####
#.#.#...#.#
#.#.###.#.#
#...#.....#
###########
