###########
#...#.....#
#.#.#.#####
#.#..E#...#
###.###.#.#
#.....#.#.#
#.#.###.###
#.#.......#
#.#.#####.#
#.#.#.....#
#.#####.###
#...#.....#
#.#######.#
#...#.....#
#.#.#####.#
#.#.#.....#
###.#.###.#
#...#.#...#
###.#####.#
#...#.....#
#.###.###.#
#.#.....#.#
###.#.###.#
#.#.#.#.#.#
#.#.###.#.#
#.......#S#
###########
