###########
#.......#.#
#.#.###.#.#
#.#.#.#.#.#
###.#.#.#.#
#S..#...#.#
#####.###.#
#...#.#...#
#.#.#.###.#
#.#...#...#
#.#####.#.#
#.....#.#.#
#####.#.#.#
#...#.#.#.#
#.#.#.#.###
#.#.#.#...#
#.#.#.#.#.#
#.#.#.#.#.#
#.#.#.###.#
#.#.#.....#
###.#####.#
#.......#E#
#.#######.#
#.....#...#
#.###.#.###
#...#.....#
###########
