###########
#.........#
#.#######.#
#.....#.#.#
#.###.#.#.#
#.#...#.#.#
###.###.#.#
#E..#.....#
#.#####.###
#.....#...#
#####.###.#
#.....#.#.#
#.#####.#.#
#...#...#.#
#.#.#.###.#
#.#.#...#.#
#.#.#.#.#.#
#.#.#.#...#
#.#.#.#####
#.#.#.....#
#.#.#######
#.#.#S....#
###.#####.#
#...#.....#
#.###.#####
#.....#...#
#.#####.#.#
#.......#.#
###########
