###########
#.........#
#.#####.#.#
#.#.....#.#
###.#.#####
#...#.#...#
#.###.#.#.#
#.#...#S#.#
#.#.#####.#
#.#.#...#.#
#.###.#.#.#
#...#.#.#.#
###.#.#.#.#
#...#.#...#
#.###.#####
#...#.#...#
###.#.###.#
#...#.#...#
#.###.#.#.#
#...#...#.#
#.#.#####.#
#.#...#...#
#.###.#.###
#E..#...#.#
###.#####.#
#...#...#.#
#.###.#.#.#
#.....#...#
###########
