###########
#S........#
#####.#.#.#
#...#.#.#.#
#.#####.#.#
#.#.....#.#
#.###.###.#
#...#.#...#
#.#####.#.#
#.......#.#
###.#####.#
#.#.#.#.#.#
#.#.#.#.#.#
#.....#...#
#.###.###.#
#.#...#...#
#####.#####
#..E..#.#.#
###.###.#.#
#.........#
###########
