###########
#.........#
#.#########
#.#.......#
#.#.#####.#
#...#...#.#
#.###.#.#.#
#.#...#.#.#
#.#.###.#.#
#.#.#...#.#
#.#.#####.#
#.#...#E..#
#.#.#.#.###
#.#.#.#...#
#.#.#.###.#
#.#.#...#.#
#.#.###.#.#
#.#...#.#.#
#.#.###.#.#
#.#.#...#.#
#.###.#.#.#
#.#...#.#.#
#.#.###.#.#
#...#...#.#
#####.###.#
#...#.#.#.#
#.#.#.#.#.#
#.#.....#S#
###########
