###########
#.........#
#########.#
#.......#.#
#.###.#.###
#....E#...#
#.#######.#
#.......#.#
#.#####.#.#
#.....#.#.#
#.#####.#.#
#.....#.#.#
#.#.###.###
#.#...#...#
#.#########
#.........#
#.#####.#.#
#.....#.#.#
#.#########
#S........#
#.#####.#.#
#.....#.#.#
###.#.###.#
#.#.#...#.#
#########.#
#.......#.#
###########
