###########
#...#S..#.#
#.#.###.#.#
#.#...#...#
#.#######.#
#...#.....#
#.#.#.#####
#.#...#...#
#.#######.#
#...#.....#
###.#.#####
#...#.....#
#.#######.#
#.....#...#
#####.#.#.#
#...#...#.#
#.#.#####.#
#.#E#...#.#
#.#.###.#.#
#.#.....#.#
#.#######.#
#.#...#...#
#.#.#.#.###
#...#.....#
###########
