###########
#.........#
#.###.#.#.#
#...#.#.#.#
#.#.#.#.###
#.#.#.#...#
###.###.###
#.#...#...#
#.#.###.###
#........S#
#.#.###.#.#
#E#...#.#.#
#####.###.#
#...#...#.#
#########.#
#.......#.#
###.###.###
#.#...#...#
#.#.#.#.#.#
#.#.#.#.#.#
###########
