###########
#.........#
###.#####.#
#...#.....#
#.#########
#...#.#S..#
#.#.#.###.#
#.#.#...#.#
#.#.#.#.#.#
#.#...#...#
#########.#
#...#.#...#
#.#.#.#.#.#
#.#.#.#.#.#
#.#.#.###.#
#.#..E#.#.#
#.#####.#.#
#.#.......#
#.#.#.###.#
#...#.#...#
#######.#.#
#.#.....#.#
#.#.#.###.#
#...#.#...#
###########
