###########
#S......#.#
#####.###.#
#.....#...#
###.#.#.###
#.#.#...#.#
#.#.#####.#
#...#.#...#
#.###.#.#.#
#...#...#E#
###.#.#####
#...#.....#
#.#####.###
#.#.#.#...#
#.#.#.###.#
#...#.#.#.#
###.#.#.#.#
#.#.#.#.#.#
#.#.#.#.#.#
#.........#
###.#######
#.#.#.....#
#.#.#.###.#
#.......#.#
###########
