###########
#.........#
###########
#........E#
#.#.#.#####
#...#.....#
###.###.###
#.....#...#
###.#######
#.........#
###.#######
#.#.......#
###.#.#####
#..S#.....#
#######.###
#.....#...#
#.#####.#.#
#.....#.#.#
#.#.###.###
#.#...#...#
#######.###
#.....#...#
###########
