###########
#.........#
#.#.###.###
#.#...#...#
###.#######
#......S..#
#.###.#.#.#
#...#.#.#.#
#.#.#.###.#
#.#.#...#.#
#.#.#.#.#.#
#.#.#.#.#.#
#.#.#.#.###
#.#.#.#...#
#.###.###.#
#E..#...#.#
#.#.#.#.###
#.#.#.#...#
#####.#.#.#
#...#.#.#.#
#.#####.#.#
#.....#.#.#
###########
