###########
#.....#...#
#.#####.###
#.....#...#
###.#.#.###
#...#.....#
#.#########
#.........#
###.#.#.###
#...#.#...#
###.#####.#
#.#...#E#.#
#.#.###.#.#
#...#.#...#
###.#.###.#
#.......#.#
###.###.###
#...#.#...#
#.#.#.#.#.#
#S#.#...#.#
###########
