###########
#.......#.#
###.###.#.#
#E..#...#.#
#.#####.#.#
#.....#...#
#.###.#####
#...#.....#
###.#####.#
#.......#.#
#.#######.#
#...#.....#
#####.#####
#.....#...#
#.#####.#.#
#...#...#.#
#.#.#.###.#
#.#...#...#
#######.#.#
#.......#.#
#.#######.#
#.#.......#
#.###.#####
#...#.#...#
###.#.###.#
#S..#.....#
###########
