###########
#.#...#...#
#.###.#.###
#.......#.#
###.#.#.#.#
#...#.#...#
###.#.###.#
#.#.#...#.#
#.###.#####
#...#.#...#
###.#.#.###
#.#.#.#.#.#
#.#.#.#.#.#
#...#...#.#
#.###.###.#
#E....#.#.#
#.#.###.#.#
#.#.#...#.#
###.#.###.#
#.......#.#
#.#####.#.#
#.#...#...#
#.#.#####.#
#.....#.#.#
#.###.#.#.#
#.#.#...#.#
#.#.###.###
#...#S....#
###########
