###########
#E......#.#
#####.#.#.#
#...#.#.#.#
#.#.#.#.#.#
#.#...#.#.#
#.#####.#.#
#...#...#.#
#.#.###.#.#
#.#...#...#
#####.###.#
#.....#.#.#
#.#####.#.#
#.....#.#.#
#####.#.#.#
#.....#...#
#.#######.#
#.......#.#
#.#####.#.#
#.#...#.#.#
#.###.#.#.#
#.....#.#.#
#.#####.###
#.#...#...#
#.#.#.###.#
#.#S#.....#
###########
