###########
#.....#..S#
#.#####.###
#.....#.#.#
#.###.#.#.#
#.#.#...#.#
#.#.#####.#
#.#.......#
#.#.#.#####
#.#.#.....#
#.#####.#.#
#..E..#.#.#
#####.###.#
#...#...#.#
#.#####.#.#
#.....#.#.#
###.#.#.#.#
#...#.#.#.#
#.#####.#.#
#.#...#.#.#
#.#.#.#.#.#
#...#.....#
###########
