###########
#.........#
###.#.#.###
#.#.#.#...#
#.#.#.###.#
#.#.#...#.#
#.#.###.#.#
#E........#
#####.#.#.#
#...#.#.#.#
###.#####.#
#.#.......#
###.#.#.#.#
#.#.#.#.#.#
#.#.#.###.#
#.#.#...#.#
#.#.#####.#
#.#......S#
#.###.#####
#...#.....#
#.#########
#.........#
#####.#####
#...#.....#
###########
