###########
#.#.......#
#.#.###.#.#
#...#...#.#
#.###.#####
#...#.....#
###.#####.#
#.#.#...#.#
#.#.###.#.#
#.#.....#S#
#.#####.###
#.#...#...#
#.#.#.###.#
#...#.#...#
#.###.#.###
#.#...#.#.#
#.#.###.#.#
#.#.#...#.#
###.#.###.#
#...#...#.#
#.#####.#.#
#.#...#.#.#
#.#.#.#.#.#
#E..#.....#
###########
