###########
#.#.#S#.#.#
#.#.#.#.#.#
#.#...#.#.#
#.#.#.#.#.#
#...#.....#
###.#####.#
#.....#...#
#.#######.#
#E#.....#.#
#.#####.###
#.#.#.#...#
#.#.#.#.###
#...#.....#
###.#.#.#.#
#.....#.#.#
#######.###
#.....#...#
#.###.#.###
#...#.#...#
###.###.###
#.........#
###########
