###########
#.....#...#
#.#.#.#.#.#
#.#.#.#.#.#
###.#.###.#
#...#...#.#
#.#####.#.#
#..E..#...#
#.###.###.#
#.#.#...#.#
#.#.###.#.#
#...#...#.#
#.###.###.#
#.#...#.#.#
#.#.###.#.#
#.#.#.....#
#.#.#.#####
#.#.#.....#
#.#.#####.#
#.#....S#.#
###########
