###########
#.........#
#.#.#.###.#
#.#.#...#.#
#.###.#.#.#
#...#.#.#.#
#.###.###.#
#...#...#.#
###########
#.........#
#.#####.#.#
#..S..#.#.#
#.#####.#.#
#.....#.#.#
#.#.###.###
#.#...#...#
#.#.###.###
#.#...#...#
#.#.#.#.#.#
#.#.#.#.#.#
#.###.###.#
#...#...#.#
#.#.###.#.#
#E#...#.#.#
#####.###.#
#...#...#.#
###.#####.#
#.#.....#.#
###########
