###########
#.........#
#.###.#.###
#...#.#...#
###.###.###
#.#..E#...#
#.#.#.#.###
#.#.#.#...#
#.#.#.#.#.#
#.#.#.#.#.#
#.#.#.#####
#...#.....#
###.#.#####
#...#.....#
#.#.#######
#.#.......#
#.#.#.#####
#.#.#.....#
#.#.#.#.###
#...#.#...#
###.#.#.###
#...#.#...#
###.#.#####
#.#.#.....#
###.#.###.#
#.#.#...#.#
#.#.#.#.#.#
#.#S#.#.#.#
###########
