###########
#.........#
#####.#.#.#
#...#E....#
#####.#.#.#
#...#.#.#.#
#####.#.#.#
#...#.#...#
#########.#
#.......#.#
#.#.#####.#
#.#.......#
#.###.#.#.#
#...#.#.#.#
#####.#.#.#
#...#.#...#
#####.###.#
#...#...#S#
#.#########
#.........#
###.#######
#.#.......#
###.#####.#
#.#.....#.#
###########
