###########
#...#E..#.#
###.###.#.#
#.........#
###.#####.#
#...#.....#
###.#######
#S..#.....#
###.#.###.#
#.....#...#
#####.#.#.#
#.#...#.#.#
#.#####.###
#.....#...#
#.#.###.#.#
#.#...#.#.#
###.#.#.###
#...#.#.#.#
###.###.#.#
#...#...#.#
###.###.#.#
#.........#
#.#.###.###
#.#.#.#.#.#
#####.#.#.#
#.........#
###########
