###########
#.........#
###.#.#####
#.#.#.....#
###.#######
#.#....E..#
###.###.#.#
#.#...#.#.#
###.###.#.#
#.#...#.#.#
#######.###
#.....#...#
###.###.#.#
#.#.....#.#
#.#.###.###
#.#...#...#
#.#.#.#.#.#
#.#.#...#.#
#.###.#.#.#
#...#.#S#.#
###########
