###########
#...#.....#
###.###.#.#
#.....#.#.#
#.#######.#
#.#...#.#.#
#.###.#.#.#
#.........#
#.#####.###
#S#.......#
#######.###
#.........#
###.#####.#
#.#.#.#...#
#.#.#.#####
#.....#...#
#.#.#.#.###
#.#.#.....#
#.#.#####.#
#.#.#.....#
#.#.###.###
#.#...#...#
#.#######.#
#.#.#...#.#
#.#.###.#.#
#...#.#.#.#
###.#.#.#.#
#.#.#.....#
#.###.###.#
#.....#..E#
###########
