###########
#S#...#.#.#
#.###.#.#.#
#.#...#...#
#.###.#.###
#.#.......#
#.#.#####.#
#...#.#...#
###.#.###.#
#.....#.#.#
#.#####.#.#
#.#...#.#.#
#.#.#.#.#.#
#.#.#...#.#
#.#.#####.#
#...#...#.#
#.#####.#.#
#.#...#...#
#.###.#.###
#.#...#...#
#.###.#####
#.......#.#
#####.###.#
#.#E..#.#.#
#.#.###.#.#
#.....#...#
#.#.###.###
#.#.#.#...#
#.###.#.#.#
#.......#.#
###########
