###########
#.....#...#
#.###.###.#
#...#.#...#
#.#.#.#.#.#
#.#.#...#.#
#.#.#######
#.#E......#
#.#######.#
#...#.....#
#####.###.#
#.....#...#
#.#######.#
#.......#.#
#######.#.#
#.....#S#.#
#.###.###.#
#...#...#.#
###.#.###.#
#...#.....#
#.#########
#.#.......#
#.#.#####.#
#.#.....#.#
#.#####.#.#
#.....#.#.#
#####.###.#
#...#.#...#
#.#.#.#.#.#
#.#.....#.#
###########
