###########
#.........#
#####.#.###
#...#.#...#
#.#.#####.#
#.#.....#.#
#.#######.#
#.......#.#
#.#.#.#.###
#.#.#.#...#
#.#.#.#####
#.#.#.....#
#.#.#.#.#.#
#.#.#.#.#.#
#.#.#.#####
#.#.#.....#
#####.#.#.#
#......E#.#
#.#######.#
#.......#.#
#.#.#######
#.#.......#
#.#####.###
#.....#...#
#.#.#######
#S#.......#
#####.#####
#...#.....#
#####.#.#.#
#...#.#.#.#
###########
