###########
#.#S#...#.#
#.#.###.#.#
#.....#...#
###.#####.#
#.........#
#.###.###.#
#...#.#.#.#
#######.#.#
#...#.#...#
#.###.#.#.#
#.......#.#
#.#######.#
#.#.....#.#
#.#.#.#####
#...#.....#
#####.#####
#.......#.#
#####.###.#
#...#.#...#
###.#.###.#
#...#...#.#
###.###.#.#
#......E..#
#.#.#####.#
#.#.#.#...#
#####.###.#
#.#.......#
#.#.###.#.#
#.....#.#.#
###########
