###########
#.........#
###.#.###.#
#.#.#...#.#
###.#######
#.#.......#
###.#####.#
#.#E....#.#
#.#.#.###.#
#.#.#...#.#
###.#.#.###
#.#...#...#
#.#.#.###.#
#.#.#...#.#
###.#.#.#.#
#.#...#.#.#
#.###.#####
#.........#
#####.#####
#...#.....#
###.#.#.#.#
#.#...#.#.#
###.#.#.#.#
#.#...#.#.#
#.#.#.#####
#.#..S....#
###.#####.#
#.#.....#.#
#.#.#######
#.#.......#
###########
