###########
#.........#
#####.#.###
#...#.#...#
###.#####.#
#.#.....#.#
###.###.#.#
#.#...#.#.#
###.#.###.#
#.#.#...#.#
#.#.#######
#S........#
###.#.#####
#.#.#.....#
#.#.#.###.#
#.#.#...#.#
#####.#.#.#
#.....#.#.#
#####.#####
#.........#
#.#.#.###.#
#.#.....#.#
#.###.###.#
#...#E..#.#
#.#.#.###.#
#.#.#...#.#
###.#######
#.#.......#
#.###.###.#
#...#...#.#
###########
