###########
#...#.....#
###.#.#.#.#
#...#.#.#.#
#.#.#.#.###
#.#.#.#...#
#.###.###.#
#.....#.#.#
#.#####.#.#
#.....#.#.#
#####.#.#.#
#...#...#.#
#.#.###.#.#
#.#...#.#S#
#.###.#.###
#.#...#...#
#.#.#####.#
#.#.....#.#
#.#####.#.#
#.#...#...#
#.#.#.#####
#.#.#.#...#
#.#.#.#.#.#
#.#.#...#.#
#.#.#####.#
#.#...#...#
#.#####.#.#
#..E#...#.#
###.#.###.#
#.....#...#
###########
