###########
#...#.....#
#.#.#.#.#.#
#.#..E#.#.#
#.#####.###
#.....#...#
#########.#
#.........#
#.#######.#
#.#.......#
#.#.#####.#
#.#.#...#.#
#.###.#.#.#
#.....#.#.#
#######.###
#.....#...#
#.###.###.#
#...#.....#
#.#.#######
#.#.#.....#
###.#.###.#
#S#.....#.#
#.#######.#
#...#...#.#
###.#.#.#.#
#.#...#...#
#.#######.#
#.....#...#
#.#.###.###
#.#.......#
###########
