#############
#...#.....#.#
#.#.#.###.#.#
#.#...#.#.#.#
#.#####.#.#.#
#.#.......#.#
#.#.#######.#
#S#.....#...#
#######.#.#.#
#......E..#.#
#############
