#############
#.#....S#.#.#
#.#.#.###.#.#
#.#.#...#...#
#.#####.#.###
#.......#...#
#.###.#.###.#
#...#.#.....#
#.###.###.###
#.#...#.....#
#####.#.#.###
#.#.#.#.#...#
#.#.#.###.###
#....E#.....#
###.#.#####.#
#...#...#...#
#############
