#############
#...........#
#.#.#.###.###
#.#.#...#...#
#####.###.###
#...#...#...#
###.#.#######
#.#E........#
#.#.###.#####
#.#...#S....#
#############
