#############
#...#.#.#...#
###.#.#.#.###
#.#.........#
#.#.#######.#
#.#.#...#.#.#
#.#.###.#.#.#
#.#.#...#...#
#.#####.#.#.#
#....E..#.#.#
###.#.#.#.#.#
#.#.#.#...#S#
#.#.#.#.#####
#...#.#.....#
#############
