#############
#...........#
#.###.#######
#.#...#..E..#
#.#.###.###.#
#.#...#...#.#
#####.###.#.#
#..S#.....#.#
#.###.#####.#
#...#...#...#
###.###.#.###
#...#...#...#
#.###.#####.#
#.#...#.....#
#.#####.###.#
#.......#...#
#############
