#############
#.#.........#
#.#.#######.#
#.#.#.....#.#
#.#.#.#.###.#
#.#.#.#...#.#
#.#.#####.#.#
#.#...#S#.#.#
#.###.#.#.#.#
#...#...#.#.#
###.#####.#.#
#...#.....#.#
#.###.#.###.#
#.#...#.#...#
#.#.###.#.###
#..E..#.....#
#############
