#############
#.#.#.......#
#.#.#######.#
#.......#...#
###.###.#.#.#
#.....#.#.#.#
#######.#.###
#...#...#.#.#
#.#####.#.#.#
#.#.....#...#
#.###.#.#.###
#...#.#.#...#
#.#.#.#####.#
#S#.......#.#
###.###.#.#.#
#...#...#..E#
#############
