#############
#......E....#
#.#.#.#.#####
#...#.#.....#
###.###.#.###
#.....#.#...#
#.#.#####.#.#
#.#.....#.#.#
#.#.#.#.###.#
#...#.#...#.#
#.#.#.#.#####
#.#S#.#.....#
#############
