#############
#....S......#
#.#.#########
#.#.........#
###.###.###.#
#.....#...#.#
###.#.#.#.#.#
#...#.#.#.#.#
#.#.###.#####
#.#E..#.....#
###.#.#.#####
#.#.#.#.....#
#############
