#############
#...#.....#.#
#.###.#.#.#.#
#.....#.#...#
#.#####.###.#
#.#...#.#E..#
###.#.#.#.###
#...#...#.#.#
#.#######.#.#
#.....#.....#
#.###.#####.#
#...#.....#.#
###.#####.#.#
#.#.#...#.#.#
#.#.#.###.#.#
#.....#S..#.#
#############
