#############
#E.........S#
#.#.#.###.###
#.#.#...#...#
#.#.#####.#.#
#.#.....#.#.#
#.###.###.#.#
#...#...#.#.#
###.###.#.#.#
#.#...#.#.#.#
#############
