#############
#.#.........#
#.###.#.#####
#.#.#.#....S#
#.#.#.###.###
#...#...#...#
###.#.###.###
#..E....#.#.#
#.###.#.###.#
#...#.#...#.#
#.#.#######.#
#.#.........#
#.#####.#####
#...#.......#
#############
