#############
#.....#.....#
#.#####.#####
#E#.........#
#.#####.###.#
#...#...#.#.#
###.#.#.#.###
#...#.#.....#
#.###.#####.#
#.......#...#
#.#######.#.#
#.....#...#.#
###.#.###.###
#...#.#....S#
#############
