#############
#...........#
#####.###.###
#...#E..#...#
###.#.#####.#
#.#.#.....#.#
#.#######.#.#
#.......#.#.#
###.#.#.#.#.#
#.#.#.#.#.#.#
#####.###.#.#
#...#...#.#.#
#.###.#.#.###
#...#.#.#...#
#.#.#.#.#.#.#
#.#.#.#.#S#.#
#############
