#############
#.....#.#...#
#.###.#.#.#.#
#.#...#E..#.#
###.###.#.#.#
#.......#.#.#
#.#.#.###.#.#
#.#.#.#.#.#.#
#.#.#.#.#.###
#S#.#...#...#
#############
