#############
#.#.........#
#.#######.###
#E..#.#.....#
###.#.#####.#
#...#.#.#...#
#.#.#.#.###.#
#.#...#.#...#
#####.#.#.###
#...........#
#.#######.###
#.#.....#...#
#.#.#####.#.#
#...#.....#.#
###.#.#.#####
#...#.#.....#
#.#.#####.#.#
#.#.....#.#S#
#############
