#############
#...........#
###.###.###.#
#.#...#...#.#
#.###.#.#####
#...#.#.....#
#.###.#######
#......S....#
#.###.#.#####
#...#.#.....#
#.#.#.###.###
#E#.#...#...#
###.###.#.###
#.#...#.#...#
#######.#####
#.....#.....#
###.#.###.#.#
#.#.#...#.#.#
#############
