#############
#S......#...#
#######.###.#
#...#.....#.#
#.#######.#.#
#........E..#
#.#######.#.#
#...#.#.#.#.#
#.###.#.#.#.#
#...#.....#.#
#.#####.###.#
#...#.....#.#
#############
