#############
#...........#
#########.###
#..........E#
###.#.#.###.#
#.#.#.#...#.#
###.#.#.#####
#.#.#.......#
#.###.#.###.#
#...#.....#.#
###.#.#.###.#
#.#.#..S..#.#
#####.#.###.#
#...#.#...#.#
#############
