#############
#.#........E#
#.#.#.#####.#
#...#.#.....#
#####.#####.#
#.....#...#.#
#.#####.#.###
#.#.....#...#
#.#.#######.#
#...#.....#.#
###.#.###.#.#
#S#.#...#...#
#.#####.###.#
#.......#.#.#
#########.#.#
#.........#.#
#.#########.#
#...........#
#############
