#############
#.#.........#
#.#.#######.#
#.#.#.......#
#.#.#######.#
#E#......S#.#
#.#########.#
#.#.........#
#.#.#########
#.#.#.....#.#
#.#.#.###.#.#
#.....#.....#
#############
