#############
#....S......#
#.#.#.#.#.#.#
#.#.#.#.#.#.#
###.#####.#.#
#.#.....#.#.#
###.###.#.###
#.#...#.#...#
###.#.#.###.#
#.#.#E#...#.#
#############
