#############
#.....#.....#
#.###.#.###.#
#.#S#.#.#...#
#.#.#.#.#.#.#
#.#.#...#.#.#
#.#.#.###.###
#.#.#...#...#
#.#.###.###.#
#.#.#.#...#.#
###.#.#.###.#
#...#...#...#
#.#######.#.#
#....E....#.#
#############
