#############
#.#.........#
#.#.###.#.###
#.....#.#.#.#
###.#.#.###.#
#...#.#..E..#
#####.#.#####
#...#.#...#.#
#.#####.#.#.#
#...#...#...#
#.#.#.#######
#S#.........#
#############
