#############
#.#.........#
#.#.#.#####.#
#...#.#.#.#.#
#.#.###.#.#.#
#.#.......#S#
#.#####.#####
#.#.......#.#
#####.#####.#
#.#...#...#.#
#.#.#.#.#.#.#
#...#...#E..#
#############
