#############
#.....#S....#
#.#########.#
#.........#.#
#.#####.###.#
#E..#.#.....#
###.#.#######
#...#.......#
#.###.#####.#
#...#.#.....#
###.#.#.#####
#.#...#.#...#
#.#####.###.#
#...........#
#############
