#############
#......E....#
#.#####.#.###
#.#.....#...#
#########.#.#
#.....#...#.#
#.#.###.#.###
#.#.....#.#.#
###.#.#.###.#
#S..#.#.....#
#############
