#############
#E..........#
#.#########.#
#.#.#.......#
###.###.###.#
#...#S..#...#
#.#####.###.#
#.......#.#.#
#####.###.#.#
#.....#.....#
#############
