#############
#.....#E....#
#.###.###.#.#
#...#...#.#.#
#.#.###.#.#.#
#.#...#...#.#
#.###.#######
#.#.#.#.....#
#.#.#.#.###.#
#...#...#S..#
#############
