#############
#S..........#
#######.#.#.#
#.....#.#.#.#
#.#####.#.###
#.......#...#
###.#.#.#.#.#
#.#.#.#.#.#.#
#####.#.###.#
#...#.....#.#
#####.#.#.#.#
#...#.#.#.#.#
#######.#.###
#.......#...#
###.###.#####
#.#...#.....#
#####.#.#.###
#...#..E#...#
#############
