#############
#S..#.......#
###.#.#####.#
#...#.#...#.#
###.#.###.###
#...#...#...#
#.#.###.#.#.#
#.#...#...#.#
#####.#####.#
#.........#.#
#########.#.#
#.#E........#
#.#####.#####
#...........#
#.#.#####.#.#
#.#...#...#.#
#.#.###.#.#.#
#.#.#...#.#.#
#############
