#############
#...........#
###.#.#.#####
#.#.#.#.....#
###.#.#.#.###
#E..........#
#.###.#.###.#
#...#.#...#.#
#.#.#.#.###.#
#.#.#.#...#.#
#.#.#.#####.#
#.#.#.....#.#
#.###.#.#.#.#
#...#.#.#.#S#
#.#.#.#.#.###
#.#.#.#.#...#
###.#.#.#.###
#.#.#.#.#...#
#############
