#############
#.........#.#
#######.#.#.#
#...#...#...#
#.#.#.#####.#
#.#...#.#...#
#.#####.#.###
#E#.......#.#
#.###.#####.#
#...#.......#
#.#.#######.#
#.#..S#.....#
#############
