#############
#...........#
#.#####.#.###
#.....#.#...#
#####.#.#.###
#...#.#.#...#
###.###.#.#.#
#.#...#.#.#.#
#.#.#.#.###.#
#E........#.#
#.###.#.###.#
#...#.#S..#.#
#.#.#.###.#.#
#.#.#...#.#.#
#############
