#############
#........E..#
###.#.#.#.#.#
#.#.#.#.#.#.#
###.#.###.#.#
#.#.#...#.#.#
#.#.#.#.###.#
#.#.#.#...#S#
#.#.###.#.###
#.#...#.#...#
#########.#.#
#.......#.#.#
#############
