#############
#.#..E#.....#
#.#.#.#.###.#
#...#.#...#.#
#.###.#.#.#.#
#.#S..#.#.#.#
#.#######.#.#
#...#.....#.#
###.#.#####.#
#.....#.....#
#############
