#############
#.....#.....#
#.#.#.###.###
#.#.#.......#
#####.#.#####
#S..#.#.#...#
###.#.#.###.#
#.....#.....#
#.#######.#.#
#.....#...#.#
###.#######.#
#.......#.#.#
#.#.#.###.###
#.#.#.#...#.#
#.###.#.#.#.#
#.#E#.#.#...#
###.#.#.#.#.#
#.......#.#.#
###########.#
#...........#
###.#####.###
#.......#...#
#############
