#############
#...........#
###.#####.#.#
#.#.....#.#.#
###.###.#####
#.#...#....E#
#.#.###.#####
#.#...#.....#
#.###.#.#####
#...#.#.....#
#.###.#.#.#.#
#...#.#.#.#.#
#######.###.#
#.........#.#
###.#.#.#.###
#.#.#...#...#
#.###.#.#.###
#...#.#.#...#
#.###.#.#.###
#...#..S#...#
#.#.#####.###
#.#.....#...#
###.#.#.#.#.#
#.#.#.#.#.#.#
#.###.#.#.#.#
#...#.#.#.#.#
#############
