#############
#S..#...#.#.#
###.###.#.#.#
#.#...#.....#
#.#.###.###.#
#.......#...#
#.###.#####.#
#...#...#...#
#.#######.#.#
#...#.#.#.#.#
#.#.#.#.#.#.#
#.#.#.....#.#
#.###.#.###.#
#...#.#.#..E#
###.###.#####
#.#.#.......#
#.###.#####.#
#...#.#.....#
#.###.#####.#
#...#...#...#
#.#.#.#####.#
#.#.......#.#
#############
