#############
#.....#.....#
#####.#.###.#
#.....#...#.#
#.#######.#.#
#.#.......#E#
#.#.#######.#
#...#.#.....#
#.###.#.#####
#.#...#.....#
#.###.#####.#
#.#.....#...#
#.#.#####.###
#...#...#...#
###.#.#.###.#
#...#.#..S#.#
#.###.#####.#
#.#.#.#...#.#
#.#.#.#.#.#.#
#.#.#...#.#.#
#.#.#####.#.#
#.....#.#...#
#####.#.#####
#.#...#.....#
#.#.###.###.#
#.......#...#
#############
