#############
#.#.....#...#
#.#.#.#.#.#.#
#.#.#.#...#.#
#.#.#.#####.#
#...#.#.....#
#.###.#.#####
#.#...#.....#
#.#.#########
#.#.#.......#
###.#.#####.#
#...#.#...#.#
#.###.###.#.#
#....E....#.#
#.#########.#
#.....#...#.#
###.###.#.#.#
#.#.#...#...#
#.#.#.#####.#
#...#...#...#
#.#####.#.###
#.#S....#...#
#############
