#############
#...........#
#.#########.#
#.........#.#
#####.#.#####
#...#.#.....#
#.###.#.#####
#..E..#.....#
#.#.#.###.#.#
#.#.....#.#.#
#####.#.#####
#.....#.....#
#####.#.#####
#.....#.....#
#.###.###.#.#
#....S..#.#.#
#.#.#########
#.#.........#
#####.#.#.#.#
#...#.#.#.#.#
#.#.#.#.###.#
#.#.#.#...#.#
#############
