#############
#.....#S..#.#
#.#######.#.#
#.....#.#.#.#
#.#.###.#.#.#
#.#.#...#.#.#
###.#.###.#.#
#.#.........#
#.#####.#.###
#..E#.#.#...#
#.###.###.###
#.#.....#...#
#.#.###.###.#
#.#.#.#...#.#
#.###.###.#.#
#...#.....#.#
#.###.#.###.#
#.#...#.#...#
#.#.###.#.###
#.....#.....#
#.#######.###
#.#...#...#.#
###.###.###.#
#...........#
#############
