#############
#.......#...#
#.#####.###.#
#.#...#.....#
#.#.#.#####.#
#.#.#.#.....#
#.###.#.#####
#...#.......#
#.#.#######.#
#.#.#...#...#
###.#.#.#.###
#...#.#.#...#
#.###.#.###.#
#.#...#...#.#
#.#.#####.#.#
#.#S#...#.#.#
#.###.#.#.#.#
#.#...#.#.#.#
#.#.###.#.###
#.#.#...#...#
#.#.#.#####.#
#.#.#.#...#.#
#.#.#.#.#.#.#
#.#.#...#...#
#.#.#########
#.#...#.....#
#.###.###.#.#
#.........#E#
#############
