#############
#.......#...#
#.#####.###.#
#.....#.....#
#.#####.#.#.#
#...#S..#.#.#
#.#.#######.#
#.#.#.#.#...#
#.###.#.###.#
#.#.....#...#
#.###.#.###.#
#.#.#.#.#...#
###.#.#.#.#.#
#...#.#.#.#.#
#.#####.#.###
#E#...#...#.#
#.###.###.#.#
#.#.........#
#.###.###.#.#
#.....#...#.#
#.#.###.#.#.#
#.#.#...#.#.#
#############
