#############
#...........#
#####.#.#.###
#...#.#.#...#
###.#.#.#.#.#
#.#.#.#....S#
#.#.###.###.#
#.#...#...#.#
#.#.###.###.#
#.#...#...#.#
###.#.#.#####
#.#.#.#.....#
###.###.###.#
#.#.......#.#
#.#.###.#.#.#
#.#...#.#.#.#
#######.#.#.#
#.......#.#.#
###.###.#####
#.#...#E....#
#.###.#.#####
#...#.#.....#
###.#.#.#.#.#
#.#.#.#.#.#.#
#############
