#############
#.#...#.....#
#.#.#.#.#.#.#
#.#.#.#.#.#.#
#.#.#.#.#.###
#.#.#S#.#...#
#.#.###.###.#
#...#.#.#.#.#
#.###.#.#.#.#
#...#...#.#.#
###.#.###.#.#
#...#.....#.#
#.#######.#.#
#.....#...#.#
#####.###.#.#
#...#...#.#.#
#.#.###.###.#
#.#...#...#.#
###.#####.#.#
#...#.....#.#
#.###.#####.#
#.#..E#.....#
#.#.#######.#
#...#.......#
#.###.#####.#
#.....#.....#
#############
