#############
#.....#...#.#
#.#######.#.#
#.......#...#
#.###.###.#.#
#...#...#.#.#
###.#.#.###.#
#...#.#.#...#
###.###.###.#
#.....#.....#
###.#.#######
#...#.#.#...#
###.#.#.#.#.#
#...#...#.#S#
###.#####.###
#...#.....#.#
###.###.###.#
#...........#
#.#.#########
#.#.#.#.....#
#.#.#.#.#####
#.#.........#
#.###.#####.#
#.#...#..E..#
#############
