#############
#...........#
#.#.#######.#
#S#.#.#.#...#
###.#.#.#.###
#...#.#.#...#
#.###.#.#.###
#.#.....#...#
#.#####.###.#
#...#.#.#...#
#.###.#.###.#
#.#...#.....#
#.#.#.#.#####
#.#.#.#.....#
#.###.###.#.#
#.......#.#.#
###.###.###.#
#.....#...#.#
#####.###.#.#
#.....#...#.#
###.#.#.###.#
#...#.#.#...#
#.#.#########
#.#.#..E....#
#.###.#.#.###
#.....#.#.#.#
#.###.###.#.#
#...#...#...#
#############
