#############
#.........#.#
#.#######.#.#
#...#.....#.#
###.#.#####.#
#...#.#.....#
#.###.#.#####
#.#S..#.....#
#.#########.#
#...#.....#.#
###.#.###.#.#
#.#.#.#.....#
#.#.#.#######
#.#.#.......#
#.#.###.###.#
#.#...#...#.#
#.###.#####.#
#.#...#...#.#
#.#.###.#.#.#
#.#.#...#...#
#.#.#.#####.#
#.#..E#...#.#
#.#####.#.#.#
#.......#...#
#############
