#############
#.......#...#
#######.###.#
#.#.......#.#
#.###.###.#.#
#.#.#.#.#...#
#.#.###.###.#
#.......#...#
###.###.###.#
#.....#.#...#
#.#####.#.#.#
#E#.#.....#.#
#.#.###.###.#
#.#...#...#.#
###.###.#####
#.....#.#...#
#.###.#.#.###
#.#...#...#S#
#.#####.###.#
#...#.#...#.#
#.#.#.###.#.#
#.#...#.#.#.#
#.###.#.#.#.#
#.#.......#.#
#####.#.#.#.#
#.....#.#...#
#############
