#############
#.........#.#
#.#####.#.#.#
#.#...#.#...#
#.#.#.#.###.#
#.#.#.#...#.#
#.###.###.#.#
#.......#.#.#
#######.#.#.#
#...#.#.#.#.#
#.#.#.#.#.#.#
#.#S#...#.#.#
#.###.###.#.#
#.#...#...#.#
#.###.#.#####
#...#.#.....#
###.#######.#
#.#......E..#
#.#########.#
#.......#...#
#.#.#.###.###
#.#.#.#...#.#
#.#.###.###.#
#.#.........#
#############
