#############
#.....#.....#
#####.#.###.#
#.......#.#.#
#.#.#.###.#.#
#.#.#.#.#...#
#####.#.#####
#......E#.#.#
#####.###.#.#
#.....#...#.#
#.###.###.#.#
#.#.#...#...#
###.#.###.#.#
#S........#.#
###.#######.#
#.......#...#
#.#########.#
#.........#.#
#.#.#####.#.#
#.#...#...#.#
#############
