#############
#.#.........#
#.#.#######.#
#...#.#...#.#
###.#.#.#.#.#
#S#...#.#.#.#
#.#####.#.#.#
#...#...#...#
###.#.#####.#
#.#...#...#.#
#.#######.#.#
#.........#.#
#.#######.#.#
#...#...#.#.#
###.#.#.###.#
#...#.#...#.#
#.###.###.#.#
#.#...#.#..E#
#.#.###.#####
#...........#
#############
