#############
#.....#...#.#
#.###.#.#.#.#
#.#S#.#.#.#.#
#.#.###.#.#.#
#.#.#...#...#
#.#.#.#####.#
#.#...#.....#
#.#####.#####
#.....#.....#
#.#.#.#####.#
#.#.#.#.....#
#.#.###.#####
#.#.....#...#
#.#######.###
#.....#.#...#
#####.#.#.#.#
#.....#...#.#
#.#########.#
#...#.....#.#
###.#.###.#.#
#.....#....E#
#############
