#############
#E..#.......#
###.###.#####
#...#.#.....#
###.#.###.#.#
#.....#...#.#
#####.#.###.#
#...#.#...#.#
#.###.#####.#
#...........#
#####.###.#.#
#.....#...#.#
###########.#
#.....#.....#
#.#####.#.#.#
#...#.#.#.#.#
#.###.#.###.#
#.....#...#.#
#.###.#.###.#
#.#.....#...#
#.###.###.###
#.#...#.....#
#.#####.#.###
#.#.#...#S#.#
#.#.#######.#
#...........#
#############
