#############
#...........#
###.#########
#....S......#
#.#####.#.###
#.....#.#...#
#.#.#####.#.#
#.#.....#.#.#
#.#####.#####
#.....#.....#
#.###.###.###
#...#...#...#
#.###.#.#.###
#...#.#.#...#
#.#.#.#####.#
#.#.#.....#.#
#.#.###.###.#
#E#...#...#.#
#.#####.#.###
#.....#.#...#
#.#.#.###.###
#.#.#...#...#
#############
