#############
#...........#
#.#.#######.#
#.#.#...#E..#
#.#.#.#.#####
#.#...#.....#
#.#########.#
#.#.......#.#
#.#.###.###.#
#...#...#...#
#####.###.###
#.......#...#
###########.#
#...........#
#.#########.#
#...#.....#.#
#.#.###.###.#
#.#...#.....#
#####.#.#####
#..S#.#...#.#
#.###.###.#.#
#.#...#...#.#
#.###.#.###.#
#...#.#.....#
###.#.#####.#
#.#...#...#.#
#.#####.###.#
#...........#
#############
