#############
#.#.#...#...#
#.#.###.###.#
#.#...#.#...#
#.#.#.#.###.#
#...#.......#
#.###.#.#.###
#.#...#.#.#.#
###.#.#.#.#.#
#...#.#.#..E#
#.###.#.###.#
#...#.#.#.#.#
#######.#.#.#
#.....#.#...#
#.###.#.###.#
#...#...#...#
#.#########.#
#.#.........#
#.#.#######.#
#.#...#...#.#
###.#####.#.#
#S..#.#...#.#
###.#.###.#.#
#.....#...#.#
#####.#.#.###
#.......#...#
#############
