#############
#.......#...#
#.###.###.#.#
#.#E..#.#.#.#
#.#.###.#.#.#
#.#.#.....#.#
###.#.#######
#.........#S#
#.#####.###.#
#.#.#.....#.#
###.#.#.###.#
#.....#.#...#
#.###.#####.#
#.#.....#.#.#
#######.#.#.#
#.......#...#
#.###.#####.#
#...#.#.#...#
#.###.#.#.#.#
#.#.......#.#
#############
