#############
#......E....#
###.#####.###
#.#.....#...#
#.#.#.#.###.#
#...#.#...#.#
#.#.###.#####
#.#...#.....#
#.#.###.#.###
#.....#.#...#
###.#.#.#.###
#.#.#.#.#...#
#.#.#.#######
#.#.#.......#
#.#.#.#.#.###
#.#S#.#.#...#
#######.###.#
#.....#...#.#
#####.#.#####
#...#.#.....#
###.###.#####
#.#...#.....#
#####.#######
#...#.......#
#.#.#######.#
#.#.......#.#
#####.#######
#...#.......#
#############
