#############
#...........#
###.#.###.###
#.#.#...#...#
#########.###
#.......#...#
#.#######.###
#....S..#...#
#.###.#.#.#.#
#...#.#.#.#.#
#.###########
#...........#
#.###########
#...........#
#.###.#######
#...#.......#
#.#.#.###.###
#.#.#...#...#
#.#######.###
#.......#...#
#.#.#.#.#.#.#
#.#.#.#.#.#.#
#.###.#######
#...#.......#
#.#.#.#####.#
#E#.#.....#.#
#############
