#############
#...#...#...#
#.###.#####.#
#...#.#.#...#
#.#.#.#.#.###
#.#.........#
#######.###.#
#.......#.#.#
#.#####.#.#.#
#.#.......#.#
#########.###
#.#...#...#.#
#.###.#.###.#
#.....#.#...#
#.###.#.#.###
#...#.#.....#
#.#.#.#.###.#
#E#.#.....#.#
#.#####.#####
#.#.#.#.....#
#.#.#.###.###
#.#.#.......#
###.###.#####
#.#.....#.#.#
#.###.###.#.#
#...#.......#
#.#.###.###.#
#.#.......#S#
#############
