#############
#.......#...#
#.#.#.###.#.#
#.#.#.#...#.#
#.#.###.###.#
#.#.#...#.#S#
#.#.#.###.###
#.#...#.....#
#.#####.###.#
#.#.....#...#
#.###.###.###
#...#...#...#
###.###.###.#
#.#...#.#...#
#.###.###.###
#...#...#...#
#.#.###.###.#
#.#.#.#..E#.#
#.#.#.###.#.#
#.#.....#...#
#.#########.#
#.#...#...#.#
#.#.#.#.#.#.#
#...#...#...#
#############
