#############
#.......#...#
###.#.#####.#
#.#.#.#...#.#
#.###.#.#.#.#
#.......#...#
#.###.#####.#
#...#.....#.#
#.#.#####.#.#
#.#...#...#.#
###.###.###.#
#...#.....#.#
#.#########.#
#E#.#.#.#.#.#
#.#.#.#.#.#.#
#.....#.#...#
###.###.#.#.#
#...#...#.#.#
#.#####.###.#
#.........#S#
#############
