#############
#...#.......#
###.###.#####
#E#.#.....#.#
#.#.#.#.#.#.#
#.#...#.#...#
#.#.#######.#
#.....#.#...#
#######.#.###
#.#.........#
#.#####.#.#.#
#.....#.#.#.#
###.#.#.#.###
#.#.#...#.#.#
#.#####.###.#
#..S#.....#.#
#.#######.#.#
#.#.#.....#.#
#.#.#.###.#.#
#.....#.#.#.#
#######.#.#.#
#...#.#.....#
#.#.#.#.#.#.#
#.#.....#.#.#
#############
