#############
#...........#
#.###.###.###
#...#...#...#
###.#.#.#####
#.#.#.#.....#
#.#######.#.#
#.......#.#.#
#.###.#####.#
#..E........#
#######.#.#.#
#.....#.#...#
###.#.#.###.#
#.#.#.#...#.#
#####.#####.#
#...#.....#.#
#.#.###.###.#
#.#...#....S#
#.#.#.###.#.#
#.#.#...#.#.#
#.###.#######
#...#.......#
###.#######.#
#.#.......#.#
#########.###
#.......#...#
#.###.#####.#
#...#.....#.#
#############
