#############
#...........#
###.#####.###
#.#.....#...#
#######.#####
#.....#.....#
###.###.#####
#.#...#.....#
#.###.###.#.#
#...#...#.#.#
#.###.###.#.#
#........S#.#
#.#.#.###.###
#.#.#...#...#
#.###.#.###.#
#...#.#...#.#
#.#.#.#.#.###
#.#.#.#.#...#
#.#.#######.#
#.#.......#.#
#.#.#.#.#####
#E#.#.#.....#
#############
