#############
#...........#
#.#.#.#######
#.#.#.......#
#.###.#######
#..........E#
#.###.#######
#...#.......#
#.###.#.#####
#...#.#.....#
#.#.#.#.#.###
#.#.#.#.#...#
#.#####.#.###
#.....#.#...#
#.#######.###
#S......#...#
#.###.###.###
#...#...#...#
#####.#.###.#
#...#.#...#.#
#############
