#############
#...........#
#############
#...........#
#.#.#.#.###.#
#.#.#.#...#.#
###.###.#.###
#.#...#.#...#
#####.###.#.#
#...#...#.#.#
#.#.#####.#.#
#.#.....#.#.#
###.###.#####
#.#...#.....#
#.###.#####.#
#S..........#
#.###.#.###.#
#...#.#...#.#
#.#.#####.#.#
#.#.....#.#E#
#############
