#############
#E..........#
#.#.#########
#.#.........#
#.#.#########
#.#.........#
#.###.###.###
#...#...#...#
#######.#.#.#
#.....#.#.#.#
#.#.###.#.###
#.#...#.#...#
#.#.#####.###
#.#.....#..S#
#.#######.#.#
#.......#.#.#
#####.###.#.#
#...#...#.#.#
#.#.#.#.#.###
#.#.#.#.#...#
#####.###.###
#...#...#...#
#####.#.#.###
#...#.#.#...#
#.###########
#...........#
###.###.###.#
#.#...#...#.#
#############
