#############
#.#...#.....#
#.#.###.#.###
#....E..#.#.#
#.###.###.#.#
#...#.#.#.#.#
#.#.###.#.#.#
#.#...#.#...#
###.###.#.###
#.#.#.......#
#.###.#.###.#
#.#...#...#.#
#.#.#.#.#.#.#
#...#.#.#.#.#
###.###.###.#
#.#.#...#.#.#
#.#####.#.#.#
#.#.....#.#.#
#.#######.#.#
#...#...#...#
#.#####.#.###
#...........#
###.###.#####
#.....#...#.#
#.#.#.#.###.#
#.#.#.#.....#
#.###.#####.#
#...#.....#S#
#############
