#############
#.#.........#
#.#.#####.###
#.#.....#...#
#.#.#######.#
#...#.....#.#
#.###.###.#.#
#...#.#.#...#
###.#.#.###.#
#E..#.#...#.#
#.###.#.###.#
#...#.#.....#
#.###.#.#####
#.#...#...#.#
#.#.#####.#.#
#.#.#...#.#.#
###.#.###.#.#
#...#.......#
#.#.#######.#
#.#.#..S#...#
#.#.#.###.###
#.#.#...#...#
#.#####.###.#
#.....#.#.#.#
#.###.#.#.#.#
#.#.#.#.#...#
#.#.#.#.#.###
#...#...#...#
#############
