#############
#.......#...#
#.#####.###.#
#.#S..#...#.#
#.###.#.#.#.#
#...#.#.#.#.#
###.#.###.#.#
#...#.#...#.#
#.###.#.###.#
#.#.#...#...#
#.#.#####.#.#
#.#.......#.#
#.#########.#
#.....#...#.#
#####.#.#.#.#
#..E#...#...#
###.#######.#
#...#.....#.#
#.#.#.###.#.#
#.#.#.#.#.#.#
#.###.#.#.#.#
#.......#...#
#############
