#############
#E....#.....#
###.#.#####.#
#...#.......#
#.###.#####.#
#...#.#..S#.#
#.#.#.#.#####
#.#.#.#.....#
#.#.#.#####.#
#.#.#...#.#.#
#.#.###.#.#.#
#.#...#...#.#
#####.#.###.#
#.....#.#...#
#.#####.#.###
#...#...#...#
#.#.###.###.#
#.#...#.#...#
#.###.###.###
#...#.......#
#############
