#############
#...........#
#.#########.#
#.........#.#
#.#.#.#.#####
#.#.#.#.....#
###.#.#.#####
#.#.#.#.....#
###.#########
#.#.........#
#####.###.#.#
#...#...#.#.#
###.#.#.#.#.#
#.#.#.#.#.#.#
#.#.#.#######
#..........E#
#.###.#.#.#.#
#S..#.#.#.#.#
#.###.#.#.###
#...#.#.#...#
#############
