#############
#.......#...#
#####.#.###.#
#.....#...#.#
#.#######.#.#
#...#.#...#.#
#.#.#.#.###.#
#.#.#...#...#
###.#.###.#.#
#...#...#.#.#
#.#####.#.#.#
#.#....E#.#.#
#.#####.###.#
#.#...#.....#
#.#.#.#####.#
#...#.....#.#
#.#######.###
#.#.....#...#
###.###.###.#
#...#.#.....#
#.###.#.#####
#.#.....#S..#
#.###.#####.#
#...#.....#.#
#.#.#####.#.#
#.#.#.....#.#
#.#.#######.#
#.#.#.....#.#
#.#.#.###.#.#
#.#.....#...#
#############
