#############
#...........#
#######.#.###
#..E........#
#.#.###.#.###
#.#...#.#...#
#########.#.#
#.......#.#.#
#.#####.#.###
#.....#.....#
###.#####.###
#.#.........#
###.#####.#.#
#.#.....#.#.#
#.###.#.#.#.#
#...#.#...#.#
#######.#.#.#
#.....#.#.#.#
#.###.#.#.###
#...#.#.....#
###.#.###.###
#.#.#...#...#
#.#.###.#.#.#
#.#...#.#.#.#
#.#.#.#.#.#.#
#.#.#.#.#.#.#
###.#.#.#.###
#.#.#.#.#S..#
#.#.#.#.#.#.#
#.#.#.#.#.#.#
#############
