#############
#.......#..E#
#.#.###.###.#
#.#...#.....#
#.###.#######
#...#.......#
#.#########.#
#.#.........#
###.#.#######
#...#.#.....#
#.###.#.###.#
#.#...#...#.#
#.#####.###.#
#.#.....#...#
#.#.#####.#.#
#.#...#...#.#
#.#.###.###.#
#...#S#.#.#.#
#.###.#.#.#.#
#...#.#.#...#
###.#.#.#.###
#.#.#.#.#.#.#
#.#.#.#.#.#.#
#...#.#.#.#.#
#####.#.#.#.#
#...#.#.#.#.#
#.#.#.#.#.#.#
#.#...#.#.#.#
#.#####.#.#.#
#.......#...#
#############
