#############
#...........#
###.#.#####.#
#.#.#.....#.#
###.#.#######
#.#.#.......#
#####.#.#####
#...#.#.....#
#.#######.###
#.......#...#
#####.#.###.#
#..E......#.#
###.#.#.#.###
#.#.#.#.#...#
#####.#.#.###
#...#.#.#...#
#.#####.#.###
#.....#.#...#
#########.#.#
#.......#S#.#
#.###.#.#.###
#...#.#.#...#
#.#####.#####
#.....#.....#
###.###.#.###
#.#...#.#...#
###.###.#.###
#.#...#.#...#
#######.#####
#.....#.....#
#############
