#############
#.#.........#
#.#.#######.#
#E#.#.......#
#.#.#.#####.#
#.#.#.#.....#
#.#.#.#.#####
#...#.#.....#
#.###.#####.#
#.#.#...#.#.#
#.#.###.#.#.#
#...#S#.#...#
#.###.#.#.###
#.#...#.#...#
###.###.###.#
#...#.....#.#
#.#######.###
#.#.....#...#
#.#.###.#.#.#
#...#...#.#.#
#####.###.#.#
#.....#...#.#
#.#########.#
#.#...#...#.#
#.#.#.#.#.#.#
#.#.#.#.#.#.#
#.#.#.#.#.#.#
#...#.#.#.#.#
#####.#.#.#.#
#.......#...#
#############
