#############
#...........#
#.###.###.#.#
#.#.#.#.#.#S#
#.#.#.#.#####
#...#.#.#...#
#.#####.#.###
#.#...#.....#
#.#.###.###.#
#.....#...#.#
###.#.###.###
#E..#.....#.#
#.#.#.#####.#
#.#.#.....#.#
#.#####.###.#
#.#.........#
#.#####.#####
#.....#.....#
#######.###.#
#.#.#...#.#.#
#.#.#.###.#.#
#...#...#.#.#
###.#####.#.#
#.#.........#
#.###.#.#####
#.....#.....#
#.#.#####.###
#.#...#.#...#
#####.#.#####
#...........#
#############
