#############
#...........#
###.#.#####.#
#.#.#.....#.#
#.#.#####.#.#
#.#........S#
#####.#######
#...#.......#
###.#.#.#.#.#
#.#.#.#.#.#.#
#.#.#.#.#####
#.#.#.#.....#
###.#.#######
#.#.........#
#.#.#.#.#.###
#.#...#.#...#
#.#.#.###.###
#.#.....#...#
#####.#######
#....E......#
#####.#######
#...#.......#
#.#.###.###.#
#.#...#...#.#
###.#.#####.#
#.#.#.....#.#
###.#.#####.#
#.#.#.....#.#
#.#.#.###.#.#
#.#.#...#.#.#
#############
