#############
#.....#...#.#
#.#.###.#.#.#
#.#.#...#.#.#
#.#.#####.#.#
#.#.#.......#
#.###.#.#.###
#...#.#.#...#
#.#.#####.#.#
#.#.......#.#
#####.#######
#E..#.#...#.#
###.#.###.#.#
#.#.......#.#
#.#.#######.#
#.........#.#
#####.#.###.#
#.#...#.....#
#.###.#.#####
#...#.#..S#.#
#.###.#####.#
#.....#.#...#
#.###.#.#.###
#...#...#.#.#
###.###.#.#.#
#...#.....#.#
#.#####.###.#
#...#.......#
###.#.#######
#...#.......#
#############
