#############
#.#.#...#.#S#
#.#.###.#.#.#
#.....#.#.#.#
###.#.#.#.#.#
#.#.#...#...#
#.#.###.###.#
#...#.....#.#
#.#######.#.#
#.#.#.....#.#
###.#.#####.#
#.......#.#.#
#.#######.#.#
#...........#
#.#.#########
#.#.....#...#
#.#.#.#.###.#
#E#.#.#...#.#
###.###.#.#.#
#.....#.#...#
###.#.#.#####
#.#.#.#.....#
#.#.###.###.#
#.....#.#...#
#.#####.#.#.#
#...#.#.#.#.#
#.###.###.###
#...#.......#
#####.###.###
#.....#.....#
#############
