###############
#...........#.#
#.#.#######.#.#
#.#.#.........#
#.#.###########
#.#.#.........#
#.#.#.#######.#
#.#.#..S#.....#
#.#.#####.#####
#.#.....#.#...#
#.###.###.#.#.#
#.#.#.....#.#.#
#.#.#######.###
#.#E....#.....#
#.###.#.#####.#
#.....#.......#
###############
