###############
#S..#.........#
###.#.#######.#
#.#.#...#...#.#
#.#.###.#.#.#.#
#.#.#..E#.#.#.#
#.#.#.###.###.#
#.#.#.#.#...#.#
#.#.#.#.#.#.#.#
#.#...#...#.#.#
#.#####.###.#.#
#.........#...#
###############
