###############
#.............#
#.###.#.#.#.###
#...#S#.#.#...#
#.#.#.#.#.#.###
#.#.#.#.#.#...#
#.#.###.###.###
#.#...#...#...#
###.###.#.#.###
#.#...#.#.#...#
#.#######.#.###
#.......#.#E..#
#.###.###.###.#
#...#...#...#.#
#.#####.#.#####
#.....#.#.....#
###############
