###############
#.............#
#######.###.#.#
#.....#...#.#.#
###.###.#.#.###
#.#...#.#.#...#
#.###.#####.###
#...#.....#...#
#.###.#.#.#.###
#...#.#.#.#...#
###.#.#########
#.#.#.........#
#.###.#.#.###.#
#..E.........S#
###############
