###############
#.............#
#.###.#.#.#.###
#...#.#.#.#...#
#######.#.#####
#.....#.#.....#
#.###.#.###.###
#...#.#...#...#
#####.#######.#
#...#........E#
#.###.#.###.#.#
#...#S#...#.#.#
#.#.#####.###.#
#.#.....#...#.#
#.###.###.#.#.#
#...#...#.#.#.#
#####.#.#.#####
#...#.#.#.....#
###############
