###############
#.......#....E#
#.###.#####.#.#
#...#.#.....#.#
#.#.###.###.#.#
#.#.....#...#.#
#.###.###.#.###
#.#.....#.#...#
###.###.#######
#...#.........#
#.#.#####.#####
#.#.#.......#S#
###.###.###.#.#
#...#.....#...#
###############
