###############
#.......#.....#
#.#######.###.#
#...........#.#
#.###########.#
#.#.........#.#
#.#.#######.#.#
#.#...#...#.#.#
#.###.#.###.#.#
#...#.#.....#.#
#####.###.###.#
#..S#...#...#.#
#.#####.###.#.#
#.......#....E#
###############
