###############
#S............#
#.#####.###.#.#
#.....#...#.#.#
#.#.#####.#.###
#.#.....#.#...#
#.#####.#.#####
#.....#.#E....#
#####.###.#####
#...#...#.....#
#####.#.###.#.#
#...#.#...#.#.#
###.#.###.#.###
#.#.#...#.#...#
#######.#####.#
#.....#.....#.#
#####.#####.#.#
#...#.....#.#.#
###############
