###############
#.............#
#.#####.#.###.#
#.....#.#...#.#
#.#.###.#######
#.#...#S......#
#.#########.#.#
#.........#.#.#
###.#####.#####
#.#.....#..E..#
#.#.###.#.#.#.#
#.#...#.#.#.#.#
#.###########.#
#...........#.#
###############
