###############
#...#.........#
###.#.#######.#
#...#.#.....#.#
#.###.#.###.#.#
#.....#.#.#...#
#######.#.###.#
#.......#.....#
#.#######.#####
#S#.....#.....#
#######.#####.#
#.......#.....#
#.#.###.#.#####
#.#.#...#.#...#
#.#.#.###.#.#.#
#.#.#.#E..#.#.#
#.#.###.###.#.#
#.#.........#.#
###############
