###############
#..S..........#
#.#.###.###.###
#.#...#...#..E#
#.#########.#.#
#.........#.#.#
###.###.#.#.#.#
#.#...#.#.#.#.#
#.#.###.#.#.###
#.#...#.#.#...#
###.#.#####.#.#
#.#.#.....#.#.#
###############
