###############
#.....#.......#
#.#.###.#.#####
#.#.....#.....#
#.###########.#
#.....#.......#
#####.#.#####.#
#.....#...#...#
#.#######.#.###
#...#....E#...#
#####.#######.#
#.....#.#...#.#
#.#####.#.#.#.#
#..S#.#...#.#.#
#####.#.###.#.#
#.....#.#.#.#.#
#.#####.#.#.#.#
#.........#...#
###############
