###############
#.........#S..#
#.###.#######.#
#.#.#.....#.#.#
###.#.#.###.#.#
#.....#.......#
###.###.#.#.###
#.....#.#E#...#
#.###.###.#.###
#...#...#.#...#
###############
