###############
#S..#.....#.#.#
###.###.#.#.#.#
#.#...#.#.#...#
#.###.###.###.#
#.....#.....#.#
#####.#####.#.#
#...#E........#
#.###.#####.#.#
#...#.#.#.#.#.#
###.#.#.#.#####
#.#...........#
#.#####.###.###
#.#.......#.#.#
#.#######.#.#.#
#.........#...#
###############
