###############
#.............#
#.#####.#######
#.....#.......#
###.#######.#.#
#...#S....#.#.#
#.#######.###.#
#...#...#.#...#
###.#.#.#.#.#.#
#.....#.#E..#.#
###############
