###############
#.....#.....#.#
#.###.#.###.#.#
#.#.#...#.....#
#.#.#.#######.#
#S#.#.....#...#
###.###.#.#.###
#.......#.#.#.#
###.#####.#.#.#
#.......#.#..E#
###############
