###############
#.......#.....#
#.#######.#.#.#
#.#...#...#.#.#
#.#.#.#.###.#.#
#...#...#.#.#.#
#.#######.#.#.#
#.#.......#.#E#
#.#.#.#####.#.#
#...#.#S....#.#
###############
