###############
#.............#
#####.#.###.###
#...#.#..S....#
#######.#.#.#.#
#.....#.#.#...#
#####.#.#.###.#
#...#.#.#...#.#
#.###.#####.#.#
#...#.....#...#
#.#####.#####.#
#.....#.......#
#.#.###.#####.#
#.#...#......E#
###############
