###############
#.........#...#
#.###.###.#.#.#
#...#.#...#E#.#
#####.#.###.#.#
#..S#.#...#.#.#
#.###.###.#.###
#...#.#...#...#
###.#.#.#####.#
#.#.#.#...#...#
#.#.#.###.#.#.#
#.#...#.#.#.#.#
#.#####.#.#.#.#
#.......#...#.#
#.###########.#
#.#.........#.#
#.#.###.#####.#
#.....#.......#
###############
