###############
#.......#....E#
#.#######.#.#.#
#.#.....#.#.#.#
#.#.###.#.#.#.#
#.#...#...#.#.#
#.###.#####.#.#
#.....#S#...#.#
#.#####.#.###.#
#.#.#...#.#.#.#
#.#.#.###.#.#.#
#.#.#.#...#...#
#.#.#.#.###.###
#...#...#.....#
###############
