###############
#...#...#...#.#
#.#.###.#.###.#
#.#...........#
#####.#######.#
#.....#...#...#
###.###.#.#####
#.#E#...#.#S..#
#.#.#.#.#####.#
#.#...#.....#.#
#.#####.###.#.#
#.#...#.#.#...#
#.#.###.#.###.#
#.......#.....#
###############
