###############
#S#...#.......#
#.#.###.#####.#
#.......#.#.#.#
#.###.###.#.#.#
#...#...#.#...#
#.#####.#.###.#
#.#.#.#.#...#.#
###.#.#.#.#####
#.....#.......#
#.#####.###.###
#...#.....#.#.#
###.#.#######.#
#.#...#.#..E..#
#.#.#.#.#.#.###
#...#.....#...#
#.#.#########.#
#.#.#.........#
###############
