###############
#.#...#.......#
#.#.#.#.###.###
#...#.#..E#...#
#.###.###.###.#
#.#.#.#.#...#.#
#.#.#.#.###.#.#
#...#S#.....#.#
###.###.#####.#
#.#...#.....#.#
#.###.#######.#
#.............#
###############
