###############
#.#...........#
#.#.#.#.###.#.#
#.#.#.#.#...#.#
#.###.#########
#.......#.#E#.#
###.###.#.#.#.#
#.....#.#...#.#
#.#.#####.#.#.#
#.#.......#...#
#.#######.###.#
#.#.........#.#
#.###.#.###.###
#.#.#.#.#.....#
#.#.###.#.###.#
#.#.#.#.#...#.#
#.#.#.#####.#.#
#S#.........#.#
###############
