###############
#.............#
###.###.###.#.#
#...#.#.#...#.#
#####.###.###.#
#.#.....#.#...#
#.#.###.#.#.#.#
#.#.#.....#.#.#
#.#.#.###.###.#
#...#.#.#.#..E#
#####.#.#.#.#.#
#S......#.#.#.#
###############
