###############
#.............#
###.#.#.#####.#
#.#.#.#..S..#.#
###.#.#########
#.#.#.........#
#####.#.#######
#...#.#......E#
#.#######.###.#
#.......#...#.#
###############
