###############
#.......#....E#
#.#.###.#.###.#
#.#.#.#.#...#.#
###.#.#.#.#.#.#
#...#...#.#.#.#
#.###.#####.###
#.#.......#...#
#.#######.#.#.#
#....S#.#.#.#.#
#######.#.###.#
#.....#...#...#
#.#####.###.#.#
#...........#.#
###############
