###############
#..........S..#
###.#.#.#.###.#
#.#...#.#...#.#
#.###.###.###.#
#...#...#...#.#
#.#.#.###.###.#
#.#.....#...#.#
#####.###.#.###
#...#...#.#...#
#.#.#.###.#.#.#
#.#..E..#.#.#.#
###############
