###############
#S..#.......#.#
###.#.#.#####.#
#...#.#.#.....#
###.#.#######.#
#.......#.....#
#.#####.#.#####
#.#.#E..#.#.#.#
###.#.###.#.#.#
#...#.........#
###.#####.#####
#.#.#.#.......#
#.#.#.#####.###
#.#...........#
#.#########.#.#
#...........#.#
###############
