###############
#.....#.....#S#
#.###.#.#.###.#
#...#.#.#.....#
###.#.#.#######
#...#.#.#.....#
#.#####.#.###.#
#.......#.#...#
#.#######.#####
#...#...#.#...#
###.#.#.#.#.#.#
#.#...#.#...#.#
#.#####.#####.#
#.....#E#...#.#
#.###.#.#.#.#.#
#...#.....#...#
###############
