###############
#......S......#
#.#.###.###.###
#.#...#...#...#
###.###.#.#.###
#.#...#.#.#...#
#######.###.###
#.....#...#E..#
#.#.#.#.#.#.###
#.#.#.#.#.#...#
###############
