###############
#............E#
#######.###.#.#
#.........#.#.#
#######.###.###
#......S..#...#
#.###.#.###.#.#
#...#.#...#.#.#
#.#.###.###.#.#
#.#...#...#.#.#
###.###.#####.#
#.#...#.....#.#
#.#.#.#.#.#.#.#
#.#.#.#.#.#.#.#
#.###########.#
#...........#.#
#.#.#####.#.#.#
#.#.....#.#.#.#
###############
