###############
#.............#
#######.#.###.#
#..S..#.#...#.#
#.###.###.###.#
#...#...#...#.#
#.#.#.###.#####
#.#.#...#.....#
#.#.###.#######
#.#...#.......#
###.#.#.#####.#
#.#.#.#.....#E#
###############
