###############
#.....#.#.....#
#.#.#.#.#.#.###
#.#.#...#.#..S#
#.#.#####.#####
#.#..E..#.#...#
#######.#.###.#
#.......#...#.#
#.#########.#.#
#.............#
###############
