###############
#..........S..#
###.#.#.#.#.###
#...#.#.#.#...#
#.#.#########.#
#...........#.#
###.###.###.#.#
#.....#...#.#.#
#.#.#########.#
#.#.........#.#
###.#.###.#.#.#
#.#.#...#.#.#.#
#.#.###.#.###.#
#.....#.#...#.#
###.#.#####.#.#
#..E#.....#.#.#
###############
