###############
#.....#.....#.#
###.#.#.###.#.#
#.#.#.#.#.....#
#.#.#########.#
#.#.#.....#...#
#.#.#.#.#.#.#.#
#.....#.#.#.#E#
#######.###.#.#
#.#...#.....#.#
#.###.#.#.###.#
#.#.....#.#.#.#
#.###.#.###.#.#
#.....#.....#.#
#.###.#.###.#.#
#..S#.#...#.#.#
###############
