###############
#.....#.......#
#.###.#######.#
#.#.....#.....#
#.#####.#.###.#
#E#...#...#...#
#.#.#.#####.###
#...#...#.....#
#.#####.#####.#
#...#.#.#...#.#
###.#.#.#.#.#.#
#.....#...#S#.#
###############
