###############
#.............#
#.###.#.###.#.#
#........E#.#.#
#.###.#.#.###.#
#S..#.#.#...#.#
###.#####.#####
#.#.....#.....#
#####.#####.#.#
#...#.....#.#.#
###############
