###############
#S#...#.#.#...#
#.#.###.#.#.#.#
#...........#.#
#######.###.#.#
#.....#...#.#.#
#.#.#####.#####
#.#...#.#.#.#.#
#####.#.#.#.#.#
#.........#.#.#
#########.#.#.#
#...#.#.#.....#
#.###.#.###.###
#.......#...#.#
###.#######.#.#
#.....#.....#.#
#.###.###.###.#
#.#.....#.....#
###.#.#####.###
#.#.#.........#
#.#.#.#.#####.#
#.#.#.#.#.#...#
#.#.#####.###.#
#.......#.#..E#
#.#####.#.#.###
#.#.#...#.....#
#.#.#.#.#.#####
#.#...#.#.....#
###############
