###############
#.............#
#.#####.#######
#.#.....#.....#
#.#.#####.###.#
#.#...#.#...#.#
#.###.#.###.#.#
#...#...#...#S#
#.#.###.#.#####
#.#...#.#.....#
#.###.#######.#
#...#.....#...#
###.###.#.#.###
#.#.#E#.#.#...#
#.#.#.#.#####.#
#.#...#.....#.#
#.###.###.###.#
#...#...#.#...#
#.#.###.#.#.###
#.#...#.#...#.#
#.#.###.#####.#
#.#...#.#...#.#
#.###.#.#.#.#.#
#...#.....#...#
###############
