###############
#...#....S#...#
#.#.#.#######.#
#.#...#.....#.#
#.#####.###.#.#
#.#.....#...#.#
#.###.###.###.#
#.....#.#.#...#
#######.#.###.#
#.#.....#.....#
#.#.###.#####.#
#.#...#.....#.#
#.###.#####.#.#
#...#.....#..E#
#.#.#####.#####
#.#.#.....#...#
#.#.#.#####.#.#
#.#...#.....#.#
#.#####.#####.#
#.......#.....#
###############
