###############
#.............#
#.#########.#.#
#.....#.#...#.#
#####.#.#.###.#
#.#.....#.#.#.#
#.#.#####.#.#.#
#...#E....#...#
#.###.#########
#.#.#.........#
#.#.#########.#
#...#...#.#...#
###.#.#.#.#.#.#
#.#.#.#...#.#.#
#.#.#.###.#.#.#
#.#...#.#.#.#.#
#.#####.#.#.#.#
#.....#...#.#.#
#.#.###.###.#.#
#.#...#.#.#.#.#
#.###.#.#.#.#.#
#.#.#...#.#.#.#
#.#.#####.#.#.#
#.#.......#.#.#
#.#######.#.###
#.........#..S#
###############
