###############
#.......#.....#
#.#####.#.###.#
#.#...#.#...#.#
#.#.#.#.#.###.#
#.#.#.#...#..E#
###.#.#####.#.#
#S#.#.......#.#
#.#.#########.#
#...#.......#.#
#####.###.###.#
#.#...#.#.....#
#.#.###.#######
#.#.#.........#
#.#.###.#####.#
#.#...#.#.#...#
#.###.#.#.#.###
#.#...#...#...#
#.#.#########.#
#.#.#.......#.#
#.#.###.###.#.#
#.#.....#.#...#
#.#######.###.#
#.............#
###############
