###############
#.......#.....#
###.#.#####.###
#S#.#.#...#...#
#.#.#####.#.#.#
#.......#...#.#
#.#####.#.#####
#.#...........#
#.#####.###.#.#
#...#...#...#.#
#.#######.#.#.#
#...#.....#.#.#
###.###########
#.#.....#.#...#
#.#####.#.#.#.#
#...#...#...#.#
###.###.#.#.###
#.#.....#.#...#
#.#.#.###.#.###
#...#.....#.#.#
#.#####.#####.#
#.#.....#.....#
#####.###.#.#.#
#....E....#.#.#
###############
