###############
#.......#.....#
#.#####.#.###.#
#....S#.#.#...#
#######.#.#.#.#
#...#...#.#.#.#
#.#.#.###.#.###
#.#...#.#.#...#
#.#####.#.###.#
#.#.........#.#
#.#####.#####.#
#.....#.#.....#
#####.#.#.###.#
#.#...#.#...#E#
#.#.###.###.#.#
#.#.#.....#.#.#
#.#.#.#####.#.#
#.#.#.#...#.#.#
#.#.###.#.#.#.#
#.......#...#.#
###############
