###############
#.............#
###.#.#.#.###.#
#.#.#.#.#...#.#
#####.#####.#.#
#...#.....#.#.#
#####.#.#.#####
#...#.#.#.....#
#####.#.###.#.#
#...#.#...#.#.#
#.#.#####.#.###
#.#.....#.#...#
###.#.###.###.#
#........E..#.#
#.#.#####.#.#.#
#S#.....#.#.#.#
###.#.#.#.#.#.#
#.#.#.#.#.#.#.#
#.#.#.#.#.#.###
#.#.#.#.#.#...#
###############
