###############
#.............#
#####.#######.#
#...#.......#.#
#.#.#.#####.###
#.#.#.....#...#
###.#.#######.#
#.#.#.......#.#
###.#.#.#.#####
#.#.#.#.#.....#
#####.#.#.###.#
#...#.#.#...#.#
#.###.#.###.###
#...#.#...#...#
#.#.#.#######.#
#.#E........#.#
#####.###.#.###
#...#...#.....#
#.#####.#.#.###
#.....#.#.#...#
#.###.#####.#.#
#...#.....#.#.#
#####.#.###.###
#...#.#...#S..#
###.###.###.###
#.#...#...#...#
###.#.#.#.###.#
#.#.#.#.#...#.#
###############
