###############
#.....#E......#
#.#.#.#.#####.#
#.#.#.#.#...#.#
#.#.###.###.#.#
#.#.#...#...#.#
#.#.#.###.###.#
#.#...#...#...#
#.#####.#.#.#.#
#.#...#.#.#.#.#
#.#.#.###.#.#.#
#.#.#.....#.#.#
#.#.#.#####.#.#
#...#.#.....#.#
#####.#.#####.#
#S#.#.#.....#.#
#.#.#.#####.###
#.#.......#...#
#.###########.#
#.............#
###############
