###############
#...#E........#
#.#.#########.#
#.#...........#
#.#######.#.###
#.......#.#...#
#.#####.#.###.#
#.#.....#.#.#.#
#.#.#######.###
#.#.........#.#
#.###.#####.#.#
#S#...#.....#.#
#########.###.#
#.#.#...#.....#
#.#.#.###.#####
#.............#
#.###.###.#####
#...#.#.#.....#
#####.#.#####.#
#.....#.......#
#.#####.#####.#
#.....#.#...#.#
###.#.###.###.#
#...#.......#.#
###############
