###############
#.....#.#.#...#
###.###.#.#.###
#...#.#.....#.#
#.#.#.#####.#.#
#.#E........#.#
#.#.#######.#.#
#.#.......#...#
#####.#######.#
#.....#.......#
#.###.###.###.#
#.#...#.#.#S#.#
#####.#.###.###
#...#.#.#...#.#
#.#.#.#.#.###.#
#.#.#...#.....#
###.###.#.#.#.#
#.........#.#.#
#.#.#.#########
#.#.#.#...#...#
#####.###.#.#.#
#...........#.#
###############
