###############
#.............#
#.#.#.###.#####
#.#.#...#.....#
###.#.#.#.###.#
#.#.#.#.#...#.#
#####.#####.#.#
#..........E#.#
#.#.###########
#S#...........#
###.#.###.#.###
#.#.#...#.#...#
###.#####.#.#.#
#.#.....#.#.#.#
#######.#####.#
#.....#.....#.#
#.#######.###.#
#.......#...#.#
#######.###.#.#
#.....#...#.#.#
###############
