###############
#.........#...#
###.#.###.#.###
#...#.#...#.#S#
#.###.###.#.#.#
#...#.#.....#.#
###.#.#######.#
#...#.....#...#
###.#.###.#.###
#...#...#...#.#
#.#.###.###.#.#
#.#...#.#.#...#
###.#.###.#.###
#...#.#...#...#
#####.#.#.#.###
#..E#...#.#...#
#.#.#########.#
#.#...........#
#####.#.###.#.#
#.#...#.#...#.#
#.#.#####.#####
#.#...#.#.....#
#.#.###.#.###.#
#.......#...#.#
###############
