###############
#.#.......#...#
#.#.#####.###.#
#.#.#...#.....#
#.#.###.#####.#
#.#...#.#...#.#
#.###.#.#.#.#.#
#...#S#...#...#
#.#.###.#######
#.#...#.#.....#
#.###.#.#####.#
#.#...#...#...#
#.#.#.###.#.#.#
#.#.#...#.#.#.#
###.#####.#.###
#...#...#.#...#
#.###.#.#.###.#
#...#.#...#...#
#.#.#.#####.#.#
#.#...#.....#.#
#.#######.###.#
#E........#...#
###############
