###############
#.............#
###########.#.#
#.........#.#.#
#.###.###.#.###
#...#...#.#...#
###.###.#######
#.#...#.......#
#####.#.#.#.#.#
#...#.#.#.#.#.#
#.#.#.###.#####
#.#.#...#.....#
#.#.#.#####.#.#
#.#.#......E#.#
#.#.###.#.#####
#.#...#.#.....#
###.#.#.#.#.###
#.#.#...#.#...#
#.###.#.###.#.#
#...#..S..#.#.#
#.#.#######.#.#
#.#.......#.#.#
###############
