###############
#.............#
#.###.#########
#...#.........#
#.#.#.#.#.#.#.#
#.#.#.#.#.#.#.#
#.#############
#......E......#
###.#.###.#.#.#
#.#.....#.#.#.#
#####.#####.###
#.........#...#
#####.###.#.###
#.......#.#...#
#.###.#.#####.#
#...#.#.....#.#
###.#.#.#.#####
#.#.#S#.#.....#
#.###.#.#.###.#
#...#.#.#...#.#
###############
