###############
#.............#
#.#.###.#.#####
#.#...#.#.....#
###.#.#####.#.#
#.#.#.....#.#.#
#.#.#.#.###.###
#.#.#.#...#...#
#.###.#.###.###
#...#.#S......#
#####.#####.###
#...#.........#
###.#####.#.###
#.#.....#.#...#
#.#####.###.#.#
#.....#...#.#.#
#####.#.#.#.###
#...#.#.#.....#
#.###.#.#.#.#.#
#...#.#.#.#.#.#
#######.###.#.#
#.....#.....#.#
#.###.###.#.#.#
#...#...#.#E#.#
###.###########
#.#...........#
###############
