###############
#.#.#.#.#.#...#
#.#.#.#.#.#.###
#.....#.......#
###.#.#.#####.#
#...#.....#.#.#
###.#.#.###.###
#...#.#.......#
#.###.###.#.###
#E..#.#...#...#
#####.#######.#
#.....#...#.#.#
#.###.#.###.###
#.#.#.#...#...#
###.#.#.#.#.#.#
#.....#.#...#.#
#.#.#.###.#####
#.#.#.........#
#.#####.###.###
#.#S#...#.....#
#.#.###.#######
#...#.........#
#.###########.#
#...#.#.......#
###.#.#.#.###.#
#.....#.#...#.#
###############
