###############
#...#.#.....#.#
#.#.#.###.###.#
#.#...#.......#
#.###.#.###.###
#.#.......#...#
#.#######.#.#.#
#.#.#..E..#.#.#
#.#.#######.#.#
#.#.....#...#.#
#######.#.#.#.#
#...#.....#.#.#
#.###.#.#####.#
#.....#...#...#
###.#.#.###.###
#.#.#.#...#.#.#
#.###.#######.#
#.....#...#.#.#
#####.#.#.#.#.#
#.....#.#.....#
#.#####.#####.#
#.....#.#S....#
#####.#####.###
#.#...........#
#.#.#########.#
#.........#...#
###############
