###############
#...........#.#
#.#########.#.#
#...#.#...#...#
###.#.#.#.###.#
#...#..E#...#.#
#.###.#####.#.#
#...#.#.#...#.#
###.#.#.#.###.#
#...#.#.#.....#
#.###.#.#####.#
#.#.....#...#.#
#.#####.#.#.#.#
#.....#.#.#.#.#
#.###.###.#.###
#.#.#.....#...#
#.#.#########.#
#.#.....#S..#.#
#.#####.###.#.#
#.........#...#
#########.#####
#.......#.#...#
#.###.#.#.#.#.#
#.#...#.#...#.#
#.#.#########.#
#.#...........#
###############
