###############
#...#.....#...#
#.###.#.###.#.#
#.....#.....#.#
#.###########.#
#.#...#...#...#
###.#.#.#.#.#.#
#...#...#...#.#
#.#############
#.....#.......#
#.###.#.#####.#
#...#...#.#..E#
#.###.###.#.#.#
#.#S#.#...#.#.#
#.#.#.###.#.###
#.#.#.#...#...#
###.#.#.#####.#
#...#...#.....#
#.#####.#.###.#
#.#.....#.#.#.#
#.#.#####.#.#.#
#.#.#.....#...#
#.###.#####.###
#...#...#.#...#
###.###.#.###.#
#.#.....#...#.#
#.#######.###.#
#.............#
###############
