###############
#S............#
#.#.#.#######.#
#.#.#.......#.#
#.#.#.#####.###
#.#.#.....#...#
#.#####.#.#####
#.....#.#.....#
#.#.#.#.#.###.#
#.#.#.#.#...#.#
#########.#####
#.......#.....#
###.###.#.#####
#.#...#.#.....#
#####.###.#.###
#...#...#.#...#
#.###.###.#.###
#...#...#.#...#
###.###.#####.#
#.#...#.....#.#
#.#.#.#.###.#.#
#.#.#.#...#.#E#
#.#.###.###.###
#.#...#...#...#
#############.#
#...........#.#
###############
