###############
#....S........#
#.#.#.###.#####
#.#.#...#.....#
#.#####.#####.#
#.....#.....#.#
#.#.#.###.#.###
#.#.#...#.#...#
#.#######.###.#
#E......#...#.#
#####.#.#.###.#
#...#.#.#...#.#
#.#.#####.#####
#.#.....#.....#
###.#####.#####
#.#.....#.....#
###.#.###.#.#.#
#.#.#...#.#.#.#
#.#####.#.#.#.#
#.....#.#.#.#.#
#######.#######
#.....#.......#
#.###.###.#####
#...#...#.....#
###############
