###############
#..S#.........#
#.###.###.#####
#...#.#...#.#.#
###.#####.#.#.#
#.........#...#
#####.#.###.###
#.#.#.#.......#
#.#.###.###.#.#
#...#...#...#.#
#.#.#.#.#.#.#.#
#.#...#.#.#.#.#
#####.###.###.#
#....E#...#...#
#####.###.#.#.#
#.......#.#.#.#
#.#####.###.###
#.....#.#.....#
###.#######.#.#
#.......#...#.#
###############
