###############
#.............#
#.###########.#
#.......#...#.#
#######.#.###.#
#.......#.#...#
#.#######.#.#.#
#.....#...#.#.#
#####.###.#.###
#...#.....#...#
#.###.#######.#
#...#.#.......#
###.#.#.#####.#
#...#.#.....#.#
#.###.#####.#.#
#.#...#...#.#.#
#.#.###.#.#.#.#
#..E#...#.#.#.#
#.#####.#.#.#.#
#.....#.#.#.#.#
#####.#.#.#.#.#
#.......#.#S#.#
###############
