###############
#.............#
#####.#########
#...#.........#
#.###.###.#.#.#
#...#...#.#.#.#
###.#####.#.###
#.#.....#.#...#
#####.#.#.###.#
#...#.#.#...#.#
#####.#####.#.#
#...#.....#.#.#
#.###.#.#.###.#
#E..........#.#
#.#####.#.#.#.#
#.....#.#..S#.#
#####.#.#######
#...#.#.......#
###.###.###.###
#.#...#...#...#
#.#.###.#.###.#
#.#...#.#...#.#
#######.#.###.#
#.....#.#...#.#
###############
#.............#
#.###.#.#.#.#.#
#...#.#.#.#.#.#
###############
