###############
#.............#
###.#.#.###.###
#.#.#.#...#...#
#.#.###.#.#####
#.#...#.#....S#
###.###.###.#.#
#.#...#...#.#.#
#.#.#.#######.#
#.#.#..E....#.#
###.#####.#####
#.#.....#.....#
#.#.#########.#
#.#.........#.#
###.#######.###
#.#.......#...#
#.#.#####.#.#.#
#.#.....#.#.#.#
#.#.###.#.#####
#.#...#.#.....#
#.###.###.#.#.#
#...#...#.#.#.#
###############
