###############
#...#.........#
#.###.#.#####.#
#.#...#...#...#
#.#.#####.#.###
#...#.#...#...#
#.###.#.#######
#.#...#.......#
#.###.#######.#
#.......#.#...#
#######.#.#.#.#
#.......#.#.#.#
#.#######.#.#.#
#.#.....#.#.#E#
#.#.#.#.#.#.###
#.#.#.#...#...#
#.###.#######.#
#...#.#.......#
###.#.#.#######
#...#.#.......#
#.###.#######.#
#.....#...#...#
#####.#.#.#.###
#..S#...#.#...#
#.###########.#
#.............#
###############
