###############
#.............#
#.#####.#######
#.....#..S....#
###.###.#.#.###
#.#...#...#...#
###.#.#.#.#.#.#
#.#.#.#...#.#.#
###.###.#.#####
#.#...#.......#
#.###.#.#.#####
#...#.#.#.....#
###.###.#.###.#
#.#...#.#...#.#
#.###.###.#.###
#...#....E#...#
#.#.#.#.#####.#
#.#.#.#.....#.#
###.#.#.#.###.#
#.#.#.#.#...#.#
###.###.###.###
#.#...#...#...#
#.#.###.#.#.#.#
#.#...#.#.#.#.#
#####.#####.###
#...#.....#...#
#.#####.#######
#.....#.......#
###############
