###############
#.............#
#.###.#.###.#.#
#...#.#...#.#.#
#.#########.###
#.........#...#
###############
#.............#
###.#.#####.###
#..........E..#
#.#############
#.............#
#.#.###.#.###.#
#.#...#.#...#.#
#.#############
#.............#
#.#####.#.#.#.#
#S....#.#.#.#.#
#####.#.#.#####
#...#.#.#.....#
###.#.#.#.#.###
#.#.#.#.#.#...#
###############
