###############
#.....#S......#
###.#.#######.#
#...#.....#...#
#.###########.#
#.#...#.......#
#.###.#.#.#.#.#
#.......#.#.#.#
#.#####.#####.#
#.#.#.#...#.#.#
#.#.#.#.###.###
#...#.#.....#.#
#.#.#.#.#####.#
#.#E#.........#
#.###.###.#####
#...#.#.......#
###.#####.#####
#.....#.......#
#.###.#######.#
#...#...#.....#
###############
