###############
#.............#
###########.###
#.........#...#
#####.#.#####.#
#...#.#.....#.#
#.###.###.#####
#...#...#.....#
#.###.#.###.#.#
#...#.#...#.#.#
###.#.#.###.###
#.#.#....E#...#
###.#.###.#.#.#
#.#.....#.#.#.#
###.#.#.#######
#.#.#.#.......#
#.#.#.#####.#.#
#.#.#.....#.#.#
###.#.#####.###
#.#.......#...#
#.###.#########
#.............#
#.#.#.#######.#
#.#.#S......#.#
###############
