###############
#.............#
###.#########.#
#S#.........#.#
#.#########.#.#
#.#...#.....#.#
#.#.#.#.#####.#
#.#.#...#...#.#
#.#.#####.###.#
#...#...#...#.#
#####.#.###.#.#
#.....#.....#.#
#.#####.#####.#
#.....#.#...#.#
#.###.#.#.#.#.#
#.#...#.#.#E#.#
#.#.#####.#.#.#
#.#.....#.#.#.#
#####.#.#.#.#.#
#...#.#.#.#...#
#.#.###.#.#####
#.#.....#.#...#
#.#######.###.#
#...#...#.....#
###.#.#.#####.#
#...#.#.......#
#.###.#########
#.............#
###############
