###############
#.........#...#
#.###.###.#.#.#
#.#.#.#.#.#.#.#
#.#.#.#.#.#.#.#
#...#.#.#...#.#
#####.#.#####.#
#.....#.......#
#.#####.#####.#
#...#...#...#E#
#.#.#####.#.#.#
#.#.......#.#.#
#.#########.###
#.#.......#...#
###.#####.###.#
#...#.........#
#.###########.#
#.#.......#...#
#.#.#####.###.#
#.#.#...#...#.#
#.#.###.###.###
#.........#..S#
###############
