###############
#.#.#...#.#.#.#
#.#.###.#.#.#.#
#.#.....#.....#
#.#.#######.###
#.....#.#...#.#
#.#.#.#.#.###.#
#.#.#.....#.#.#
#.#######.#.#.#
#S#.......#.#E#
###.#####.#.#.#
#.#...#.....#.#
#.#.#.#######.#
#.#.#...#.#...#
#.###.###.#.#.#
#.#.#...#.#.#.#
#.#.#.#.#.#.###
#.....#...#...#
#####.#####.###
#.............#
#######.#######
#.....#.#...#.#
###.#.#.#.###.#
#...#.#.......#
#.#.#.#####.#.#
#.#.#...#.#.#.#
#.###.###.###.#
#.#...........#
###############
