###############
#.#..E....#...#
#.#.#.#.#####.#
#.#.#.#.#.#...#
#.###.#.#.#.#.#
#.#...#.#...#.#
#.#.###.###.###
#.....#.....#.#
#.###.#######.#
#.#...#.....#.#
#.#####.#####.#
#.#.#...#.....#
#.#.#.###.###.#
#.........#...#
#.#######.###.#
#.....#.....#.#
#####.#.###.###
#...#.#...#...#
###.#.#######.#
#.....#.#...#S#
###.###.#.#.###
#...#.....#.#.#
###.#######.#.#
#.....#...#...#
###.#.#.###.###
#.#.#.#.......#
#.#.#####.#####
#.............#
###############
