###############
#.#.....#S#.#.#
#.#.#.#.#.#.#.#
#...#.#...#...#
#.###.###.#.#.#
#.#...#.....#.#
#.#########.###
#...#.#.......#
###.#.###.###.#
#.#.#...#...#.#
#.#.#.###.#.###
#...#.#...#...#
#.###.#.###.###
#...#...#.....#
###.#####.#####
#.#.#.#.......#
#.###.#.#####.#
#...#...#...#.#
###.###.###.###
#.#...........#
#.#.#####.#.#.#
#....E..#.#.#.#
###############
