###############
#...#.....#...#
#.#.#####.#.###
#.#...#...#...#
#####.#.#.#.#.#
#.....#.#...#.#
#.#####.#.#####
#...#...#....E#
#.###.#####.###
#.......#...#.#
###########.#.#
#.............#
#.###.#.#.#.###
#...#S#.#.#.#.#
###.#####.###.#
#.#.#...#.#...#
#.#.#.#.#####.#
#.....#.....#.#
#######.#####.#
#...#.......#.#
###.#.#######.#
#.#.#...#...#.#
#.#.#.###.###.#
#.......#...#.#
#.###.#####.#.#
#.#...........#
###############
