###############
#.............#
###.#.#.#######
#.#.#.#.......#
#.#####.###.###
#.....#...#...#
#.#.#.#.#.#.###
#.#.#.#.#.#...#
#.#.#.###.#.#.#
#.#....S#.#.#.#
###.###.#.#.###
#.....#.#.#...#
#.#.###.#.###.#
#.#...#.#...#.#
#.#.#.#######.#
#.#.#.......#.#
###.###.#######
#.#...#.......#
###.###.#.#####
#.#...#.#.....#
#.#.#.#.#.#.###
#.#.#.#.#.#...#
###.###.#.#####
#.#E..#.#.....#
#####.#########
#...#.........#
###############
