###############
#.........#...#
#.###.###.###.#
#...#.#.#.....#
#.###.#.#####.#
#.#...#.#.....#
###.###.#.#####
#...#...#.#...#
#.###.#.#.#.#.#
#...#.#.#.#.#.#
#.#.#.#.#.###.#
#.#.#.#...#...#
###.#.#####.#.#
#...#.#.....#.#
#.###.#####.#.#
#.#.#.#.....#.#
#.#.#.#.#####.#
#.#.#.#.#.....#
#.#.#.#.#####.#
#.#.#.#.....#.#
#.#.#.#.###.#.#
#.#.#.#...#.#.#
#.#.#.###.#.###
#S#.#...#.#...#
###.###.#.###.#
#.....#.#...#.#
#.###.#.#####.#
#...#......E..#
###############
