###############
#.#.#.......#.#
#.#.#.#.#####.#
#...#.#.#.....#
#.###.#######.#
#.........#...#
#.###.###.#.###
#.#...#..E#.#.#
#.#.#.#####.#.#
#.#.#.........#
#.###.#######.#
#.#.........#.#
#.#############
#.............#
###.#######.#.#
#...#...#.#.#.#
#.#####.#.#.###
#.......#...#S#
#.#.#########.#
#.#...........#
###############
