###############
#.............#
#.###.###.#####
#...#...#.....#
#.#.###.#.###.#
#.#...#.#S..#.#
###.#.#.#.#.###
#.#.#.#.#.#...#
#.###.#.#####.#
#...#.#.....#.#
###.#######.###
#.#.......#...#
#.#######.#.###
#.......#.#..E#
#####.#.#.#####
#...#.#.#.....#
#.###.#.#.###.#
#...#.#.#...#.#
#####.#####.###
#...#.....#...#
#.###.#.#.#####
#...#.#.#.....#
#.#####.#.#.#.#
#.....#.#.#.#.#
###############
