###############
#.......#.#...#
#.#####.#.#.###
#.#...#.......#
#.###.#.#.###.#
#.....#.#.#...#
###########.###
#.#.........#S#
#.###.#.#####.#
#.#.#.#.#.....#
#.#.#.#####.###
#...#...#.#.#.#
###.#.###.#.#.#
#.........#.#.#
#######.###.#.#
#.......#.#...#
###.#.###.#.###
#..E#.#.....#.#
#.#####.###.#.#
#.#.......#...#
#.#####.###.#.#
#.........#.#.#
###############
