###############
#...#.......#.#
#.#.#.#####.#.#
#.#...#.#.....#
#.#####.#.#####
#.#.........#S#
#.#######.###.#
#.......#.#...#
#.#####.###.###
#.....#.....#.#
#####.#######.#
#.#...#.#.....#
#.#.###.#.#.###
#...#.....#...#
#.###########.#
#.......#...#.#
#######.#.#.#.#
#.....#...#...#
#.###.#######.#
#.#.#...#.....#
#.#.#.###.#####
#...#...#...#.#
###.###.###.#.#
#...#.#...#...#
#.###.###.###.#
#...#...#...#.#
###.###.#.###.#
#.#...#.#....E#
#.###.#.#######
#.............#
###############
