###############
#.....#.....#.#
###.#.###.#.#.#
#...#.....#...#
#.###########.#
#.#.....#...#.#
#.#.###.#.#.###
#.#.#.#...#...#
#.#.#.#######.#
#.#.#.....#.#.#
#.#.#.#.#.#.#.#
#.#.#.#.#...#.#
#.#.###.#####.#
#.#..E#...#...#
#.###.###.#.###
#...#.#...#...#
#.#.#.#.#.###.#
#.#.....#.#.#.#
#########.#.#.#
#.......#...#.#
#.#####.#####.#
#.#...#.#.....#
#.#.###.#.###.#
#.#...#...#...#
#.###.#####.###
#.#.......#.#.#
#.#.###.###.#.#
#S#...#.#...#.#
###.#.###.###.#
#...#.........#
###############
