###############
#.............#
#.#.#.#.#.#.###
#.#.#.#.#.#...#
#####.#.#.###.#
#...#.#.#...#.#
#.#.#######.#.#
#.#.......#.#.#
#######.#.###.#
#.....#.#...#.#
#.#.#.#.###.#.#
#.#.#.#S......#
#.###.#.#.###.#
#...#.#.#...#.#
###.#.#.###.#.#
#.#.#.#...#.#.#
#.###.#.#####.#
#...#.#.......#
#.#######.###.#
#.......#...#.#
#.#.#####.#.#.#
#.#.....#.#.#.#
#.#.#.#######.#
#.#.#........E#
#.#.#.#.#######
#.#.#.#.......#
#.#####.#####.#
#.....#.....#.#
###.#.###.#####
#.#.#...#.....#
###############
