###############
#.....#.#.#...#
#####.#.#.###.#
#...........#.#
###.#########.#
#.#...#.......#
#.#.###.###.###
#.#.......#.#.#
#.#.#########.#
#.#........E#.#
#.#.###.#####.#
#.#...#...#.#.#
#.#######.#.#.#
#...#.#.......#
#.#.#.#####.###
#.#...........#
#######.#####.#
#.....#.....#.#
#.#####.#.###.#
#.#.#S#.#.#...#
#.#.#.#####.###
#...#.....#...#
#.#######.###.#
#.#...........#
#.#.#####.#.###
#.#.#.#.#.#.#.#
#.#.#.#.#.#.#.#
#...#.....#.#.#
#.#########.#.#
#.........#...#
###############
