###############
#........S....#
#####.###.###.#
#...#...#.....#
###.#.#.###.#.#
#.#.#.#...#.#.#
#.#.###.#.###.#
#.#...#.#...#.#
###.#########.#
#.#.........#.#
#.#.#####.#.#.#
#.#.....#.#.#.#
###.#.#.#.###.#
#.#.#.#.#...#.#
#.#.###.###.#.#
#.#...#...#..E#
#.#####.#.#.#.#
#.....#.#.#.#.#
#.#.#.#####.#.#
#.#.#.....#.#.#
#.###.#####.###
#...#.....#...#
#.###.#.#.#.#.#
#...#.#.#.#.#.#
#.#.#####.###.#
#.#.....#...#.#
###.#.#####.#.#
#.#.#.....#.#.#
#.#####.###.#.#
#.....#...#.#.#
###############
