###############
#.#.....#.....#
#.#.###.#.#.###
#.#E..#.#.#...#
#.###.#.#.###.#
#.#...#.#...#.#
#.#.###.#.###.#
#.#.#.#...#...#
#.#.#.#####.#.#
#...#.....#.#.#
#.###.###.#.###
#.#...#...#...#
#.###.#.#####.#
#...#.#.#S#...#
###.###.#.#.###
#.#.....#...#.#
#.#####.#####.#
#...#...#.....#
#.###.#######.#
#...#.....#...#
#.#.#####.#.###
#.#.#.....#...#
#.#.#.#####.#.#
#.#...#...#.#.#
#.#####.#.###.#
#.#...#.#.#...#
#.#.#.#.#.#.#.#
#...#...#.#.#.#
#########.#.#.#
#...........#.#
###############
