###############
#......E......#
###.#.#######.#
#.#.#.......#.#
###.###.###.###
#.#...#...#...#
###.#.#####.###
#.#.#.....#...#
#.#.#####.#.###
#.#.....#.#...#
###.#.#######.#
#.#.#.......#.#
#.#.#########.#
#...........#.#
#.#.#.###.#.###
#.#.#...#.#...#
#.#.###########
#.#...........#
###.###########
#..S..........#
###.#####.###.#
#.#.....#...#.#
###.#.#.#.#.#.#
#.#.#.#.#.#.#.#
#######.#.###.#
#.....#.#...#.#
#####.#.###.#.#
#...#.#...#.#.#
###.#######.#.#
#.#.......#.#.#
###############
