###############
#.......#...#S#
#.#####.#.#.#.#
#.....#...#.#.#
#####.#######.#
#.#.....#.....#
#.#.#######.#.#
#.....#...#.#.#
#.###.###.#.###
#.#...#.#.#.#.#
###.###.#.#.#.#
#.....#...#...#
#.###.###.#.#.#
#.#.........#.#
###.#####.#.###
#.....#.#.#...#
#####.#.#####.#
#.......#.#...#
#.#####.#.###.#
#...#.#...#.#.#
#.###.#####.###
#.........#...#
#########.###.#
#...#...#.#E#.#
###.#.###.#.#.#
#.......#...#.#
###.#####.#.#.#
#.....#...#...#
#.#.#####.#####
#.#...........#
###############
