#################
#...............#
#.#.###.#.#####.#
#E#...#.#.....#.#
#.#.###.#.#.#.#.#
#.#...#.#.#.#S#.#
###.#######.#####
#.#.......#.....#
#.#.#.###.###.###
#.#.#...#...#...#
#################
