#################
#.....#.........#
#.###.#.#.#####.#
#...#E..#.#...#.#
#.#.#######.#.###
#.#.........#...#
#.#############.#
#.#...#...#S#...#
#.#.###.#.#.#.#.#
#...#...#...#.#.#
###.#.#######.#.#
#...#.........#.#
#################
