#################
#...............#
#.###.#.#########
#...#.#......E..#
#.#.###.#.#######
#.#...#.#.......#
#.#############.#
#.............#.#
###.#.#.###.###.#
#.#.#.#...#...#.#
#.#.#######.#.#.#
#.#.......#.#.#.#
###.###.#.#.###.#
#.#...#.#.#...#.#
#.#.#.###.#.#####
#.#.#..S#.#.....#
#################
