#################
#...#...#.....#.#
###.#.#.#.#.###.#
#...#.#...#.....#
###.#.###.#####.#
#.#.....#.#.#...#
#.#.#######.#####
#.......#S..#...#
###.#######.#.#.#
#.....#.......#.#
#.###.#.#.###.###
#.#.#...#...#.#E#
#.#.###.#.#.###.#
#.....#.#.#.....#
#.###.#.#.#####.#
#.#...#.#.#.....#
#################
