#################
#.....#.#.......#
###.#.#.#.###.###
#.#.#...#.#.....#
#.#.#######.#.###
#...#.#.#...#...#
###.#.#.#.#######
#.....#.#.#S..#.#
###.###.#.###.#.#
#.........#.#...#
#####.###.#.###.#
#.....#.#.......#
#.#####.#.#.#####
#.#.#.#...#.....#
#.#.#.#.###.#.###
#.#...#.#E..#...#
#.#.#.#########.#
#...#.#.........#
#################
