#################
#S..#...#.....#.#
###.###.#.#####.#
#.#...#.#...#...#
#.#.###.###.#.#.#
#...#...#.#.#.#.#
###.###.#.#.###.#
#.............#.#
#.#####.#######.#
#...#...#.....#.#
###.###.###.###.#
#.#...#.#E......#
#.#####.#####.#.#
#.............#.#
#################
