#################
#...............#
###.#######.#.#.#
#.#.......#.#.#.#
#.###.#.#.###.#.#
#...#.#.#...#.#.#
#.###########.#.#
#...........#.#.#
###.###########.#
#.#...........#.#
#.#.###.###.###.#
#.#...#S.......E#
#################
