#################
#...#S........#.#
#.###########.#.#
#...#...........#
#.#.#.#.#.#######
#.#...#.#.#.....#
###.#.#######.#.#
#E..#.#.....#.#.#
#.#.#.###.#.###.#
#.#.#.#...#.#...#
#.###.###.#.###.#
#...#.....#...#.#
#.###.#######.#.#
#.#.....#.......#
#################
