#################
#.......#.#...#.#
#####.###.#.###.#
#.......#....E..#
#.#.#####.#######
#.#.............#
#.###.#.#.#.#.#.#
#.#...#.#.#.#.#.#
#.#.###.#.###.###
#.#.#...#...#...#
#.#.###.#####.#.#
#.#...#.#.....#S#
###.###.#.###.###
#.....#.#.#...#.#
#.#########.###.#
#.#.....#.......#
#.#.###########.#
#.............#.#
#################
