#################
#.........#.....#
###.###.###.###.#
#...#...#...#...#
#.#######.###.#.#
#.#.......#...#E#
#.#.#######.###.#
#...#.#S..#.#...#
#.###.###.#.#.###
#.......#...#...#
#################
