#################
#............E..#
#####.#.#.#.#.#.#
#.....#.#.#.#.#.#
#.#.#.#.###.#.#.#
#.#.#.#...#.#.#.#
#.###.#####.#.#.#
#....S....#.#.#.#
#####.#.#.###.#.#
#...#.#.#...#.#.#
###.#.#.#########
#.#.#.#.........#
###.#.#.###.###.#
#.#.#.#...#...#.#
#################
