#################
#...............#
#######.###.#####
#.....#...#.....#
#.###.###.#.#.###
#E..#...#.#.#...#
#.#####.#.###.###
#.....#.#...#...#
#.#######.#.#.###
#.......#.#.#...#
#.#.#.###.#.#.###
#.#.#...#.#.#...#
#.#.###.###.#.###
#.#...#...#.#...#
#.###.#######.###
#...#.......#...#
#.#######.###.#.#
#S......#...#.#.#
#################
