#################
#...............#
#######.#.###.#.#
#.....#.#...#.#.#
#####.#.#.#.#.###
#...#.#.#.#.#...#
#.#.#.#.#######.#
#.#....E......#.#
#.#.#######.#####
#.#.......#.....#
###.#########.###
#...........#...#
#.#.#########.#.#
#.#.........#.#.#
###.#####.#####.#
#.#S....#.....#.#
###.#####.#.#####
#.#.....#.#.....#
#################
