#################
#...#..E........#
#.###.#.#######.#
#.#...#...#.....#
#.#.#####.###.###
#...#...#...#...#
#.###.#.###.###.#
#...#.#.#.#.#...#
###.#.#.#.#.#.###
#.....#...#S#...#
#################
