#################
#.............#E#
#########.###.#.#
#.....#...#.#...#
#.###.#.#.#.#####
#...#...#.#.....#
###.#####.#.#####
#S#.#.......#...#
#.###.#.###.###.#
#.....#.#.......#
#################
