#################
#..............E#
#.###.###.#######
#...#...#.......#
###########.#.#.#
#.....#.....#.#.#
#.#######.#.###.#
#.#.#.....#.#...#
#.#.#.###.#.#.###
#.....#...#.#...#
#.#.###.#####.###
#.#.#.....#.#...#
#####.#.###.###.#
#S....#.#.......#
#################
