#################
#.....#.........#
#.#####.#####.#.#
#.......#...#.#.#
#.#######.#.#.###
#...#...#.#.#...#
###.###.#.#.###.#
#E#...#.#.#.....#
#.###.#.#.#####.#
#.......#.#...#.#
#########.#.###.#
#...#.....#...#.#
#.#.#.#####.#.#.#
#.#...#.....#...#
#.###############
#..............S#
#################
