#################
#.#.......#S#...#
#.#######.#.#.#.#
#.#.....#...#.#.#
#.#####.#.#####.#
#.#E#.#.........#
#.#.#.#.#.#####.#
#...#...#.....#.#
#.###.###.#.#####
#.......#.#.#...#
#.###.###.#####.#
#.#.....#.#.....#
#.###.###.###.#.#
#...#.#.......#.#
#.#####.#######.#
#.#.#.....#.....#
###.###.###.###.#
#.......#...#...#
#################
