#################
#...............#
#.#.#.#.#.#######
#.#.#.#.#......S#
#.#.#.###.#.#####
#.#.#...#.#.....#
#.#####.#.#######
#.....#.#.......#
###.#######.#.###
#.#.......#.#E..#
#################
