#################
#.............#.#
#.###########.#.#
#...#...#...#...#
#.#.#.#.#.#.#####
#.#..E#...#.#S..#
#.#########.###.#
#...#...#.....#.#
###.#.#.#.#####.#
#.....#.#.......#
#################
