#################
#...............#
#####.###########
#...#...........#
#####.#.###.###.#
#...#.#...#...#.#
#.#.#######.#####
#.#.......#.....#
#.###.#####.###.#
#..S............#
#####.#.#######.#
#...#.#.......#.#
#.###.#.#.#.#.#.#
#...#.#.#.#.#.#.#
#######.#######.#
#.....#.......#.#
#####.#######.#.#
#...#.......#.#E#
#################
