#################
#...............#
#########.#####.#
#.......#.....#.#
#.#####.#.#.###.#
#.....#.#.#...#.#
#####.#.###.#.###
#...#.#S........#
#.#.#.#####.###.#
#.#.#.....#...#E#
#.###.#.#.#.###.#
#...#.#.#.#...#.#
#######.#.#####.#
#.....#.#.....#.#
#################
