#################
#...............#
#######.###.#.###
#.....#...#.#...#
#.#############.#
#.............#.#
#.###.#.#########
#...#.#.........#
###.#.###.#######
#.#.#..S#......E#
###.###.#####.###
#.#...#.....#...#
#################
