#################
#.....#...#.....#
#.###.#.#.#.###.#
#.#.#.#.#.#...#.#
#.#.#.#.#.#.###.#
#.#...#.#.#.#...#
#.#####.#.#.#.###
#.#...#.#.#.#...#
#.#.#.#.#.#####.#
#E..#...#.....#.#
#.###########.#.#
#...#.....#.#S#.#
###.#.###.#.###.#
#...#.#.#.#.....#
#.###.#.#.#.###.#
#.....#.....#...#
#################
