#################
#..E..#.....#...#
#.###.#.###.#.#.#
#.#.#.....#...#.#
#.#.#######.###.#
#...#.....#...#.#
#####.###.#####.#
#.....#.#.....#.#
#.#####.#####.#.#
#.#...#.#.......#
#.#.#.#.#.#######
#.#.#.#...#S....#
#.#.#.#########.#
#...#...........#
#################
