#################
#S....#.#.#E....#
#####.#.#.#.#.###
#.....#.#.#.#...#
#.###.#.#.#.#####
#.#.#...#.......#
#.#.###.###.#.#.#
#...#.#.#...#.#.#
###.#.###.###.#.#
#.......#.#...#.#
#.#.#.###.#.###.#
#.#.#.....#.#...#
#################
