#################
#...#.....#....S#
###.#.###.#.#####
#...#.#.#...#...#
#.###.#.#######.#
#.....#.........#
#.#####.#####.#.#
#...#.....#...#.#
###.#######.###.#
#.#.#.......#...#
#.#.#.#######.###
#....E#.........#
#################
