#################
#.#.....#......S#
#.#.###.###.#####
#.....#...#...#.#
#.###.#.#####.#.#
#...#.#.#.#.#...#
#######.#.#.#.#.#
#.......#.#...#.#
###.#####.#####.#
#.....#E#...#.#.#
#.#####.###.#.#.#
#...#.......#...#
#.###.#####.#.#.#
#.........#...#.#
#.#.#######.###.#
#.#.......#...#.#
#################
