#################
#.#...#.........#
#.#.###.#####.###
#....E......#...#
#.#####.#####.#.#
#.#.....#.....#.#
###.#.###.###.###
#...#.#.#.#...#.#
#####.#.#######.#
#...............#
###.###.###.###.#
#S....#...#.#...#
#################
