#################
#.....#.....#...#
#.###.#.###.#.#.#
#...#.#.#.#...#.#
#####.#.#.#####.#
#.....#.....#S#.#
#.###.###.###.#.#
#.#.....#.#...#.#
#.#######.#.###.#
#.#.......#...#.#
#.#.#########.#.#
#.#.#.#.......#.#
#.#.#.#.#######.#
#..E..#.........#
#################
