#################
#.#S#...........#
#.#.#.###.###.###
#.#.....#.#.....#
#.#####.###.###.#
#.......#.#.#...#
#.#.#.###.#####.#
#.#.#.#.#..E..#.#
#.###.#.###.#.###
#.#.........#...#
#################
