#################
#.#S#...........#
#.#.#.#########.#
#...#.....#.....#
#.#########.#####
#.#.......#.....#
#.#.#####.#####.#
#...#...#.#E..#.#
#####.#.#.#.#.#.#
#.#...#.#...#.#.#
#.#.#.#.#####.#.#
#...#.#...#...#.#
#####.#####.###.#
#.....#...#.#...#
#.#####.#.#.#.#.#
#.......#.....#.#
#################
