#################
#.#.....#.......#
#.#.###.#.#####.#
#...#.#.#.....#.#
#.###.#.###.###.#
#.#...#.#...#...#
#.###.#.###.#.###
#.#...#...#.#...#
#.#.#.###.#.###.#
#...#.#.#S#...#.#
#####.#.#######.#
#...#.#.........#
#.#.#.#.###.###.#
#.#.#.#...#.#.#.#
#.#.#.###.#.#.#.#
#.#.#...#.#.#.#.#
#.#.###.###.#.#.#
#.#E........#...#
#################
