#################
#.......#.......#
#.#.#####.#####.#
#E#.........#.#.#
###########.#.#.#
#...#.....#...#.#
#.#.#.###.###.#.#
#.#...#S#...#.#.#
#.###.#.###.###.#
#.#...#.#.#.....#
#.#####.#.#####.#
#.......#.......#
#################
