#################
#..E........#S..#
#.#####.###.###.#
#.#.#...#...#...#
#.#.#.###.###.###
#...#...#...#.#.#
###.###.###.#.#.#
#.....#.#...#.#.#
#.#####.#####.#.#
#.#...#.#.....#.#
#.#.#.#.#.#####.#
#.#.#...#.....#.#
#.#.#########.#.#
#.#.........#...#
#.#######.#####.#
#.....#.#.#...#.#
#####.#.#.#.#.#.#
#.......#...#...#
#################
