#################
#...............#
###.#.#########.#
#.#.#.........#.#
#.#.#.#####.#####
#.#.#.....#.....#
#.#.#############
#.#.............#
#########.#.###.#
#S.......E#...#.#
#################
