#################
#.......#....E..#
#.###.###.#####.#
#.#.#.........#.#
#.#.###########.#
#.......#.......#
#.#######.#####.#
#.#...#...#...#.#
###.#.#.#####.#.#
#...#...#.....#.#
#.#######.###.#.#
#...#.....#...#.#
###.#.###.#.###.#
#...#.#...#...#.#
#.#.###.#######.#
#.#.#S#...#.....#
#.###.#.#.#.#####
#.....#.#.......#
#################
