#################
#...............#
###########.#.#.#
#.........#.#.#.#
#####.#.###.#.#.#
#...#.#...#.#.#.#
###.#.###.#.#####
#.#.#...#.#.....#
###########.#####
#............S..#
#.#.###.#####.#.#
#.#.........#.#.#
###.###.#####.###
#.#...#E....#...#
#################
