#################
#...#...........#
#.#.#.#####.###.#
#.#.....#.#.#...#
#######.#.#.###.#
#..S#.....#...#.#
#.#######.###.###
#.#.....#...#...#
#.#.###.#######.#
#...#.#.#.....#.#
#####.#.#.###.#.#
#.....#.#...#.#.#
#.#.###.###.#.#.#
#.#........E#...#
#################
