#################
#E......#.#....S#
#.#####.#.###.###
#.....#.......#.#
#.#.###.#######.#
#.#.#.#.#.....#.#
#.#.#.#.#.#####.#
#.#.#...........#
###.#.#######.#.#
#...#.......#.#.#
#.###.###.#.###.#
#...#.#...#...#.#
#################
