#################
#...............#
#.###.#.###.#.#.#
#...#.#...#.#.#.#
#.#.#.#.###.#.###
#.#.#.#...#.#...#
#.#.#.###.#.#####
#.#.#...#.#.....#
#.###.#.#####.#.#
#...#.#S....#.#E#
#.#.#####.#.###.#
#.#.....#.#...#.#
#################
