#################
#...#.........#.#
#.#.#.#.#####.#.#
#.#.#.#.#...#..E#
###.#.#####.#.###
#S......#.......#
#####.#######.#.#
#.......#.....#.#
#.#.#.###.###.###
#.#.#...#...#...#
#################
