#################
#...............#
#####.###.#.#.#.#
#...#...#.#.#.#.#
###.###.#.###.###
#.#...#.#...#...#
#####.#.#.#######
#...#.#.#.......#
#.#.#####.#.###.#
#.#.....#.#...#.#
#######.#.#.#.#.#
#..S..#.#.#.#.#.#
#.#.#.#.###.#.#.#
#.#.#.#...#.#.#.#
#####.#######.###
#...#......E#...#
#################
