#################
#...........#...#
#.#########.###.#
#...#...#...#...#
###.###.###.#.###
#.#.......#.....#
#.#.#.#.#######.#
#.#.#.#E....#...#
#.#.#.#.#.###.#.#
#...#.#.#.#.#.#.#
###.#.#####.#.###
#.#.#.#.....#.#.#
#.###.#.#.###.#.#
#.....#.#.......#
#.#####.#.#######
#.....#.#......S#
#################
