#################
#.......#...#.#.#
#######.###.#.#.#
#.....#.........#
#.#.#.#.###.###.#
#.#.#.#.#...#...#
#.#.###.#####.###
#.#.#.....#...#.#
#.###.#####.#.#.#
#.....#.#...#...#
###.###.###.#.###
#....E#.#...#...#
#######.###.#.#.#
#...........#.#.#
#.###.#.###.###.#
#.#.#.#...#...#.#
###.###.#.#.#####
#.#.....#.#.....#
#.#.###.###.#.###
#.#...#.#.#.#...#
#.#.#.###.###.###
#...#.#.....#...#
#####.#.#.###.#.#
#.....#.#.#.#.#.#
#.#######.#.#.#.#
#.#...........#.#
#.#.###.###.#.#.#
#.#...#..S#.#.#.#
#################
