#################
#...........#...#
###.#######.###.#
#...#E#.....#...#
#.###.#.#####.#.#
#.#...#...#...#.#
#.###.###.#.###.#
#...#.......#...#
#.#.#.#######.###
#.#.#.#...#...#S#
###.###.#.###.#.#
#...#...#...#.#.#
#.###.#####.###.#
#.#...#.....#...#
#.#.###.#.###.###
#.....#.#.#...#.#
#.#####.#.#.###.#
#.#.#...#.#.#...#
#.#.#.#.###.#.###
#...#.#.#...#...#
###.#.###.#####.#
#...#...........#
#################
