#################
#..........E....#
#######.#.###.###
#.....#.#.......#
#.#####.#.#.#.###
#.....#.#.#.#...#
#.#.#########.#.#
#.#...........#.#
#.#.#.#.#####.###
#.#.#.#.....#...#
###.###.#.###.#.#
#.#...#.#...#.#.#
#.#.###.###.#.###
#.#...#...#..S..#
#.#####.#.#####.#
#.....#.#.....#.#
###.#.#.#####.#.#
#.#.#.#.....#.#.#
###.#.#####.###.#
#.#.#.....#...#.#
###########.#.#.#
#.........#.#.#.#
#.###.#.#.#####.#
#...#.#.#.....#.#
###.#.#.#.#######
#.#.#.#.#.......#
#################
