#################
#E..............#
#.#.#.#.#.###.###
#.#.#...#...#...#
#.#.###.#########
#.#...#.........#
#.#.#.#.#####.#.#
#.#.#.......#.#.#
#.###.#.#.#####.#
#...#.#.#.....#.#
#####.#.#.#######
#...#.#.#.......#
#.#.#.#.#######.#
#.#.#.#.......#.#
#####.#.#######.#
#...#.........#.#
#.#.#.#.###.#####
#.#.#.....#.....#
#.#####.#.#######
#.......#.......#
#.#####.#####.#.#
#......S....#.#.#
#################
