#################
#..E............#
#####.#.#.#.#.#.#
#...#.#.#.#.#.#.#
#.#.#.###.###.#.#
#.#.#.......#.#.#
#.###.###.#######
#...#...#.......#
#.#####.#.#.###.#
#.....#...#...#.#
###.#####.#####.#
#.#.....#.....#.#
#.#.###.#.#.###.#
#.#...#...#...#.#
#.#.#.#.#.#.#####
#.#.#.#..S#.....#
###.###.#######.#
#.#...#.......#.#
###.###.###.#.###
#.#...#...#.#...#
#######.#####.#.#
#.....#.....#.#.#
#################
