#################
#.....#.........#
#.#.#.###.#####.#
#.#.#...#...#...#
#.#.###.#####.#.#
#.#.#.#...#...#.#
#.#.#.###.#.###.#
#.#.#...#...#...#
#.#.#.#.#####.###
#.#.#.#.....#...#
###.#.#####.###.#
#...#...#...#...#
#.#######.#.#.###
#.#.......#.#.#.#
#.#.#.#.#####.#.#
#.#.#.#.#.....#.#
#.###.###.#####.#
#...#...#.......#
#.#.###.#######.#
#.#...#.......#.#
#.###.#.#####.#.#
#E..#.#.....#...#
#####.#####.#####
#.....#.....#..S#
#.###########.###
#...............#
#################
