#################
#...............#
#.#.#.###.#.#####
#.#.#E..#.#.....#
#.#.#.#.#.#####.#
#.#.#.#.#.....#.#
#.#########.###.#
#.........#...#.#
###.#######.#.#.#
#.#.......#.#.#.#
#.#####.#.#######
#.....#.#....S..#
#.###.###.#.#.#.#
#...#...#.#.#.#.#
#####.#.#.#######
#...#.#.#.......#
#####.#####.#.#.#
#...#.....#.#.#.#
#.#.#.#.#.###.#.#
#.#.#.#.#...#.#.#
#######.#.#######
#.....#.#.......#
#.#.#.###.###.#.#
#.#.#...#...#.#.#
#.#######.###.###
#.......#...#...#
#################
