#################
#.......#.......#
###.###.#.#.###.#
#...#.....#...#.#
###.#####.#####.#
#...#.#.....#...#
#.###.###.#######
#.....#...#.#.#.#
#.#.#####.#.#.#.#
#.#.#...#.#.....#
###.#.###.###.#.#
#...#.#.#.#.#.#.#
#.#.#.#.#.#.###.#
#.#.#.......#...#
###.#####.###.###
#.....#..E#.....#
###.#######.#####
#.#.............#
#.#.#.#.###.###.#
#...#.#.#.....#S#
#################
