#################
#...............#
#.###############
#.....#...#.....#
#.###.#.#.#.###.#
#.#.#...#.#.#...#
#.#.#####.#.#.###
#.#.#...#...#...#
#.#.#.#.#######.#
#...#.#.........#
#####.#########.#
#...#.......#.#.#
#.#.#.#####.#.#.#
#.#S#.....#.#.#.#
#.#########.#.#.#
#.#.........#...#
#.#.#########.###
#...#.......#.#.#
#####.#####.#.#.#
#.....#...#.#.#.#
#.#######.#.#.#.#
#.#.....#E#...#.#
#.###.#.#.#####.#
#.....#.........#
#################
