#################
#.#.....#...#...#
#.#.#######.#.###
#.#.#.......#...#
#.#.###.#.#####.#
#...#...#...#.#.#
###.#.#####.#.#.#
#.......#.......#
###.#.#####.###.#
#...#.....#...#.#
#.#.###.#.###.###
#.#.#.#.#...#E..#
###.#.#######.#.#
#.......#.....#.#
###.#####.#######
#.....#.#.#.....#
#.#.###.###.#.###
#.#...#.....#...#
###.#.###.###.###
#S#.#.....#...#.#
#.###.#.#.#.#.#.#
#.....#.#.#.#...#
#################
