#################
#.#...#.#.#....S#
#.#.###.#.#.#.###
#...#.#...#.#...#
#.###.#.###.#.###
#...#.....#.#.#.#
#.#####.#.#.###.#
#.....#.#...#...#
#.###.###.#.#.#.#
#E#.......#.#.#.#
###.#####.###.#.#
#.#...#...#...#.#
#.#.#.#######.###
#.#.#.......#...#
#.#####.#####.#.#
#...#.........#.#
###.#.#.###.#####
#.#...#.#.#.#...#
#.###.###.#####.#
#...............#
#################
