#################
#S..#.......#...#
###.#.#.###.#.###
#.....#...#.....#
#.#######.###.###
#.#.#.....#.#...#
###.###.#.#.#.###
#.#.....#.#.....#
#.#.#.###########
#...#...........#
###.#####.###.###
#.#.....#.#.#.#.#
#.#.#.###.#.###.#
#...#.#.....#...#
###.#####.#####.#
#...#.....#.....#
#.###.#####.#####
#.#.......#E....#
#.#########.###.#
#.............#.#
#################
