#################
#...............#
#.###.#.#.#.#####
#...#.#.#.#.....#
#.###.#.#######.#
#...#.#.......#.#
###.###.#####.###
#.#..E#.....#...#
###.###.#.#.###.#
#.#...#.#.#...#.#
#.#.#.###.###.#.#
#.#.#...#...#.#.#
###.###.#####.#.#
#.#...#.....#.#.#
#.#.#.#.#######.#
#.#.#.#....S..#.#
#.#.#.#.#.#.#.###
#.#.#.#.#.#.#...#
###.#.#.###.###.#
#.#.#.#...#...#.#
#################
