#################
#...............#
#.###.###.#####.#
#.#S#...#.....#.#
#.#.###.#####.###
#.#.#...#...#...#
#.#.#.###.#####.#
#.#.#.#...#.....#
###.#.###.#.###.#
#...#.#...#...#.#
#.###.#.#####.#.#
#...#...#.....#.#
###.###.#.#####.#
#...#...#.#...#.#
#.#####.#.#.#.###
#.....#.#...#...#
#####.#.#######.#
#.#...#...#.....#
#.#.#######.###.#
#E#.........#.#.#
#.###########.#.#
#.....#.......#.#
#.#.###.#.#####.#
#.#.....#.......#
#################
