#################
#...............#
#.#.#.#######.###
#.#.#.......#...#
###.#.#.#.###.###
#.#.#.#.#...#...#
#######.#.#.#.#.#
#.....#.#.#.#.#.#
#.#####.###.#.###
#.....#...#.#...#
#.#.#####.###.###
#.#.....#...#...#
#########.#.###.#
#.......#.#...#.#
#.###.#.###.#.#.#
#...#..........E#
#.###.#.#.#.#.#.#
#.....#.#.#.#.#.#
#####.#.###.###.#
#....S#...#...#.#
#.#.###.#.#.###.#
#.#...#.#.#...#.#
#.#####.#.#######
#.....#.#.......#
#################
