#################
#...........#...#
#.#########.#.###
#.#...#.....#...#
#.###.#.#######.#
#...#.#...#.....#
#.#.#.###.###.###
#.#.#...#...#...#
###.###.###.#.#.#
#...#...#...#.#.#
#.###.###.#####.#
#...#.....#E..#.#
#.#.#####.#.#.#.#
#.#.....#.#.#...#
#.#####.#.#.###.#
#.#.#...#...#...#
#.#.#.###########
#...#.......#..S#
###.#######.#.###
#.........#.....#
#################
