#################
#.....#.......#.#
#.#####.#####.#.#
#.......#...#.#.#
#.#######.#.#.#.#
#.#.....#.#...#.#
#.#.#.###.#####.#
#.#.#.#S..#.....#
#.###.#####.#.###
#...#...#...#...#
###.#.#.#.#####.#
#.#...#.#...#...#
#.#####.#####.#.#
#.....#.......#.#
###.#.#########.#
#...#.........#.#
#.###.#########.#
#...#.#.....#...#
#.#.###.###.#.###
#.#..E#.#.#...#.#
#.###.#.#.#####.#
#.#...#...#...#.#
#.#.#####.#.#.#.#
#.#.....#...#.#.#
#.###.#######.#.#
#...#...........#
#################
