#################
#............S..#
###.#.#########.#
#.#.#.........#.#
###.#.#.#.###.###
#.#.#.#.#...#...#
#.#.#.###.###.###
#.#.#...#...#...#
###.#####.###.#.#
#.......#...#.#.#
#.#.###.#########
#.....#.........#
###.#######.#####
#.#.......#.....#
###.###.###.#.#.#
#.....#...#.#.#.#
#.#.###.#########
#.#...#.........#
#.#.#.#.###.###.#
#.#.#.#...#...#.#
###.#.###.#.#####
#.#E#...#.#.....#
#####.###.#.###.#
#...#...#.#...#.#
#.#.#.###.###.#.#
#.#.#...#...#.#.#
#################
