#################
#.....#.........#
###.###.#######.#
#...#...#.#...#.#
#.#####.#.###.###
#.........#.....#
#.#.#.###.#.#.###
#.#.#.#.#...#.#.#
#.#####.#####.#.#
#.....#.#.......#
#.#####.#.#####.#
#.......#.#.....#
#.###.#.#####.###
#...#.#...#.#...#
#.#.###.###.#####
#.#.#....E......#
###.#######.#.###
#...#.......#...#
#.###.###.###.###
#...#.#.....#.#.#
###.###.#####.#.#
#S..#...#.......#
#################
