#################
#...............#
#.#.#####.#.#.###
#.#.....#.#.#...#
#.#######.###.###
#............S..#
#.#.#####.#####.#
#.#.....#.....#.#
###.#####.#######
#.......#.......#
###.###.#.#.#.#.#
#.#...#.#.#.#.#.#
#.#.###########.#
#.............#.#
#.#.###.#####.###
#.....#.....#...#
###.#.###########
#..E#...........#
#.###############
#...............#
#.#.#.###.#.###.#
#.#.#...#.#...#.#
#################
