#################
#.#...#.......#.#
#.#.###.#####.#.#
#.........#.....#
###.#########.#.#
#...#.....#...#.#
#.#.###.#.#.#####
#.#...#.#.#.#...#
#.###.#.###.#.###
#.#.#.....#S#...#
###.#.###.#####.#
#.....#.....#.#.#
#.#.#########.#.#
#.#.#.#.........#
###.#.###.#######
#.#.....#.....#.#
#.#.#.#.#.#.#.#.#
#.#.#.#...#.#...#
#.#######.#####.#
#.#...#...#...#.#
#.#.#####.#.###.#
#...........#E..#
###.#.###.###.###
#...#...#.#.....#
#################
