#################
#.....#...#.#S..#
#.#####.#.#.###.#
#.....#.#.#.#.#.#
#####.###.#.#.#.#
#.........#.#...#
###.#.###.#.#.###
#.#.#.#.#.#.....#
#.###.#.#.#.#.###
#.....#.#...#...#
#.###.#.#####.#.#
#...#.#...#...#.#
#.###.#.#####.###
#...#.#...#.....#
#.#######.#######
#...#E..#.#.....#
###.#.#.#.###.#.#
#.#.#.#.#...#.#.#
#.#.#.#####.#.###
#.....#...#...#.#
#.###.#.#.###.#.#
#.#.....#.#.....#
#.###.#.###.#.###
#.#...#.....#.#.#
#.#########.#.#.#
#.........#.#...#
#################
