#################
#...#...#.......#
###.###.#.###.###
#.#.#.....#.#.#.#
#.#.#.#####.#.#.#
#.....#.....#...#
#####.###.#######
#.#...#...#.#...#
#.#.#.#.#.#.#.###
#...#.#.#......S#
#.#########.#####
#.......#.#.....#
###.###.#.#.#.###
#...#.#.....#.#.#
#####.###.#.#.#.#
#.#.......#.#...#
#.#######.#######
#...............#
#######.###.#.###
#.#.#.#...#.#.#.#
#.#.#.#.#####.#.#
#.#...#.#...#...#
#.###.#.###.###.#
#.........#..E..#
#################
