#################
#.....#...#..S#.#
#.#####.###.###.#
#.......#...#...#
#.###.#####.#.###
#.#.....#.......#
#.###.#########.#
#.#...........#.#
###.###.#.#####.#
#.#...#.#...#.#.#
#.#.#.#.#.#.#.#.#
#.#.#.#.#.#.....#
#.#.#####.#.###.#
#.......#.#.#.#.#
#####.#######.###
#.#.....#.......#
#.#.###.#.###.###
#...#.#...#.....#
###.#.#.###.#####
#...#.....#.#...#
#.###.###.#.#.#.#
#.#.....#.#...#.#
#.#####.###.#####
#...#...#...#...#
#.#.#####.#.#.###
#.#.#.....#E....#
#################
