#################
#.#...#.....#...#
#.#.###.#.#####.#
#...#.#.#.#...#.#
###.#.###.###.#.#
#.....#.#...#...#
#####.#.#.#.###.#
#.#.......#.....#
#.#####.#######.#
#......E......#.#
#######.#####.#.#
#.....#.....#.#.#
#####.#.#.#####.#
#.#.....#...#.#.#
#.#.#.#.#####.#.#
#.#.#.#.......#.#
#.#.#.###.#####.#
#...#.#.#...#...#
#.#.#.#.#.#####.#
#.#.#.#...#.#S#.#
#.#.###.###.#.###
#.#.#.....#.....#
#.###.###.#####.#
#...#.#.......#.#
#########.###.#.#
#.........#.#...#
#.#######.#.###.#
#.#...........#.#
#################
