#################
#.#.........#...#
#.#.#.#####.#.#.#
#...#.#...#.#.#.#
#####.#.#.#.###.#
#.....#.#.#...#.#
#.#####.#.###.#.#
#E..#...#...#...#
#.#.###.###.###.#
#.#...#.#.....#.#
#.###.###.###.#.#
#...#.#...#...#.#
#####.#.#######.#
#.....#...#...#.#
#.#######.#.#.#.#
#......S#...#.#.#
#########.###.#.#
#...#.....#.#.#.#
###.#.#####.#.#.#
#...#.#.....#.#.#
#.###.#####.#.#.#
#.#...#...#.#.#.#
#.#.###.#.#.#.#.#
#.......#...#...#
#################
