#################
#..E............#
###.###.#####.#.#
#.#...#.....#.#.#
###.###.#.###.#.#
#.#...#.#...#.#.#
###.#.#.#######.#
#.#.#.#.......#.#
###.#.###.###.#.#
#.#.#...#...#...#
###.#.#######.#.#
#.#.#.......#...#
###############.#
#.............#.#
#######.#.###.#.#
#.....#.#...#.#.#
###.#######.#.#.#
#.#.......#.#...#
#.#.#.#.#.#.###.#
#.#.#.#.#.#....S#
#.###.#.#######.#
#...#.#.......#.#
###.#.#.#.#.###.#
#.#.#.#.#.#...#.#
#.#.###.#.#.#####
#.#...#.#.#.....#
#.###.#.###.#.###
#...#.#...#.#...#
#################
