#################
#.#.#.....#.....#
#.#.#.###.#####.#
#.......#.....#.#
#######.#####.#.#
#...........#...#
#####.#.#######.#
#...#.#...#.#...#
###.#####.#.#.#.#
#.....#...#...#.#
#####.###.###.#.#
#.....#.#.#...#.#
###.#.#.#.#######
#...#.#...#.....#
###.#.#.#####.###
#...#.#.......#.#
#.###.###.###.#.#
#.#.#.#.....#...#
#.#.#.#.#.#.###.#
#E..#.#.#.#.#...#
###.#.###.###.###
#.#.#.....#S#...#
#.###.#.###.###.#
#.....#.......#.#
#################
