#################
#...............#
#####.#.###.###.#
#...#.#...#...#.#
#.###########.#.#
#...........#.#.#
#####.#.#.#.#.###
#...#.#.#.#.#...#
#.###.#######.#.#
#............E#.#
###.#.#####.###.#
#.#.#.....#...#.#
#.#.###.#.###.#.#
#.....#.#...#.#.#
###.#.#.###.#.###
#...#.#...#.#...#
#.#.###.#.###.###
#.#...#.#...#...#
###.#.#.###.#.#.#
#.#.#.#...#.#.#.#
#.#.#.#.#.###.#.#
#..S#.#.#...#.#.#
###.#####.#.###.#
#.#.....#.#...#.#
#########.#.#.#.#
#.......#.#.#.#.#
#.###.###.#.###.#
#...#...#.#...#.#
#################
