#################
#.........#....S#
#.#######.#.#####
#...#.#.#.#.#...#
###.#.#.#.#.#.###
#...#...#.#.#...#
###.#.###.#.#.###
#.#...#.......#.#
#.#####.#.#.###.#
#...#...#.#.#...#
###.#.#####.#.###
#.#.....#.#.....#
#.#.#####.###.###
#.#.#...#.....#.#
#.#.#.#########.#
#.#.#.....#.....#
#.#.#####.###.#.#
#.............#.#
#####.#####.###.#
#.....#.#.#E..#.#
#.#.#.#.#.#.#.#.#
#.#.#.#...#.#.#.#
###.#.#.#####.#.#
#...#...#.....#.#
#.#####.###.###.#
#.....#...#.#...#
#################
