#################
#.........#.....#
#.#.#####.#####.#
#.#.#...#.....#.#
###.#.#.#####.#.#
#...#.#...#.....#
#.###.###.#######
#.....#.#.......#
#.#####.#######.#
#.........#...#.#
#########.#.###.#
#.....#.....#...#
#.###.#####.#.#.#
#.#.#.....#.#.#.#
#.#.#####.#.#.###
#.....#.#.#.#...#
#####.#.#.#####.#
#.#...#.#.#..S#.#
#.#.###.#.#.###.#
#E..#...#.#.#...#
#.#####.#.#.#.#.#
#.....#.#...#.#.#
#####.#.#######.#
#...#.#.......#.#
#.###.#####.#.#.#
#...........#...#
#################
