#################
#...............#
#######.###.#####
#............S..#
#.#.###.#########
#.....#.........#
###.#.#.###.#.###
#.#E#.#...#.#...#
#.###.###.###.#.#
#...#...#...#.#.#
#.#.#.###.#######
#.#.#...#.......#
#####.#######.#.#
#...#.......#.#.#
#.#.#############
#.#.............#
###.#.#######.###
#.#.#.......#...#
#.###.#.###.#.###
#...#.#...#.#...#
#################
