#################
#...#...#...#...#
###.###.###.#.###
#.#.......#...#.#
#.#######.#.###.#
#...#...#.#...#.#
#.###.###.#.#.#.#
#.........#.#.#.#
#.#########.#.#.#
#.#....E#.#.#...#
#.###.#.#.###.###
#.#...#.........#
#.###.#####.#####
#...#...#...#...#
#.#.#####.#.#.#.#
#.#.....#.#...#.#
#######.#.#######
#.........#.#...#
#.#.#.#.###.###.#
#.#.#.#.........#
#############.###
#...#.........#.#
#.#.#.#.#.#.###.#
#.#...#.#.#.....#
#.#########.#####
#S#.....#.....#.#
#####.#####.#.#.#
#...........#...#
#################
