#################
#...#S..........#
#.#######.#######
#.......#...#.#.#
#.#######.###.#.#
#.....#.....#...#
###.#.#.#.#.###.#
#.#.#.#.#.#...#.#
#.###.#.###.#.#.#
#.#.#.....#.#...#
#.#.#.#########.#
#..E#.......#...#
#.###.#.#######.#
#.#...#.#...#...#
#.###.###.#.#####
#...#.#.#.#...#.#
#.###.#.#.###.#.#
#.....#...#.#.#.#
###.#.###.#.#.#.#
#...#.#.#...#...#
###.###.#######.#
#...............#
#################
