#################
#.#.....#.....#.#
#.#.###.#.#.#.#.#
#.#...#...#.#.#.#
#.###.#####.#.#.#
#...#.#..E..#...#
#.###.#.#######.#
#.....#...#.#...#
#######.#.#.#.###
#.....#.#.#...#.#
#.###.###.#.###.#
#.#.#.....#...#.#
#.#.#########.#.#
#.#.....#...#.#.#
#.###.###.#.#.#.#
#...#...#.#.#.#.#
#.#.###.#.#.#.#.#
#.#...#...#.....#
#####.#.#######.#
#.....#...#S..#.#
#.###########.#.#
#...........#.#.#
#.#######.#.#.###
#.#.......#.#...#
###.###########.#
#...#.........#.#
#.###.#####.###.#
#.........#.....#
#################
