#################
#.......#.......#
#####.#.#.#.#####
#...#.#.#.#.#...#
#.#.#.#.#.###.#.#
#.#...#.#.....#E#
#.#####.#.#####.#
#...#.#.#.....#.#
###.#.#.#####.#.#
#...#...#...#.#.#
#.###.###.#.#.#.#
#...#...#.#.#.#.#
###.###.#.#.###.#
#...#.....#.#...#
#.#########.#.#.#
#...#.....#...#.#
###.#.###.#####.#
#.#...#.#..S#.#.#
#.#####.#####.#.#
#...............#
#################
