#################
#.....#E......#.#
###.#.#.###.#.#.#
#...#.#...#.#...#
#.###.###.#.###.#
#.#...#...#...#.#
#.#####.#####.###
#.#...#.....#...#
#.#.#.###.#####.#
#...#.....#.....#
#.#########.###.#
#...#.....#.#.#.#
#.###.###.#.#.#.#
#.#S#.#.#...#...#
#.#.#.#.#####.###
#.#.#.#.....#.#.#
###.#.#####.#.#.#
#...#.....#...#.#
#.#######.#.###.#
#...#.....#.....#
###.#.#########.#
#.....#.........#
#################
