#################
#...............#
#.#######.#####.#
#.#.#.....#.....#
#.#.#.###########
#.#.#...#.......#
#.#.###.#.#####.#
#E#...#.#.#.....#
#.#.###.#.#.#####
#...#...#S#.....#
###.#.#########.#
#.#.#.........#.#
#.#.#####.#####.#
#.#.....#...#...#
#.#.#######.#.###
#...#.......#...#
#####.###.#####.#
#.....#...#...#.#
#.#########.#.#.#
#...........#...#
#################
