#################
#.#.............#
#.#.#####.#######
#.#...#.#.......#
#.###.#.#######.#
#.....#...#...#.#
#.#####.###.#.#.#
#.....#...#.#...#
#####.#.#.#.###.#
#...#.#.#.#...#.#
#.#.#.###.###.#.#
#.#.#E..#...#.#.#
#.#.###.#.#.#.###
#.#.....#.#.#...#
#.#######.#.###.#
#.#.......#...#.#
#.###.#######.#.#
#.#...#.#...#.#.#
#.#.###.#.#.#.#.#
#...#...#.#...#.#
#####.###.#####.#
#.....#.....#...#
#.###.#.#####.#.#
#.#...#.#S..#.#.#
#.#.###.###.#.###
#.#...#.#.#.#...#
#.###.#.#.#.###.#
#...#.....#.....#
#################
