#################
#...............#
#.#.#.#.#.#.#.#.#
#.#.#.#.#.#.#.#E#
###.#.#.###.#.#.#
#.#.#.#...#.#.#.#
###.#.###.#.#.#.#
#.#S#...#.#.#.#.#
#.###.#.#.#.#####
#...#.#.#.#.....#
#.#############.#
#.............#.#
###.#.#.#.#.#####
#.#.#.#.#.#.....#
###.#.###.#.#.###
#.#.#...#.#.#...#
#.#####.###.#####
#.....#...#.....#
#.#.#.###.###.#.#
#.#.#...#...#.#.#
#.#.#.###.#.#####
#.#.#...#.#.....#
###.###.#########
#.#...#.........#
#.#########.#.#.#
#.........#.#.#.#
#######.#.#.#.###
#.....#.#.#.#...#
#################
