#################
#...............#
###.###.#####.#.#
#.#...#.....#.#.#
###.###.###.#.###
#.#...#...#.#...#
#.#######.#####.#
#.......#.....#.#
###.#####.#######
#.#.....#.......#
###.#####.#.#.#.#
#..............S#
#.###.###.#.#.###
#...#...#.#.#...#
#.###.#####.#####
#...#.....#.....#
#.#######.#####.#
#E......#.....#.#
#.###.#######.#.#
#...#.......#.#.#
#################
