#################
#...#...........#
###.#.#####.#####
#...#.....#.....#
#.#.#####.#####.#
#.#.....#...#...#
#.#########.#.###
#.#.........#...#
#.#.###########.#
#.#.#.#......S#.#
#.#.#.#.#######.#
#.#.#.#...#.....#
#.#.#.###.###.###
#...#...#...#.#.#
#.###.#.###.#.#.#
#...#.#...#...#.#
###.#.###.#####.#
#.#.#...#.#.....#
#.#.###.#.#.###.#
#.#...#.#...#...#
#.###.#.#####.###
#.....#.#.....#.#
#.#####.#.#####.#
#.......#.#.....#
#########.#####.#
#.......#.#...#.#
#.#######.#.#.#.#
#..E..#...#.#...#
#.###.#.###.###.#
#...#.......#...#
#################
