#################
#......S........#
#.#.#########.###
#...........#...#
###.#####.###.#.#
#.#.....#...#.#.#
###.#.#########.#
#.#.#.........#.#
###.#.###.#.###.#
#...#...#.#...#.#
#.#.#.#.#.###.###
#.#E#.#.#...#...#
#.#.#.###.#.#####
#.#.#...#.#.....#
#.#######.###.#.#
#.......#...#.#.#
###.#.#####.###.#
#.#.#.....#...#.#
#.#.#######.#.#.#
#.#.......#.#.#.#
###.#.#########.#
#.#.#.........#.#
#.#.#.#####.#.#.#
#.#.#.....#.#.#.#
#######.#########
#.....#.........#
###.#.#.#.#.#.###
#.#.#.#.#.#.#...#
#.#.#######.#.###
#.#.......#.#...#
#################
