#################
#...............#
#######.#.#.#####
#.....#.#.#.....#
#####.#.###.#####
#...#.#...#.....#
#####.###.###.###
#...#...#...#...#
#.###############
#...............#
#.###.###.###.#.#
#...#..S....#.#.#
#.###.#####.###.#
#...#.....#...#.#
###.#.###.#.#.#.#
#.#.#...#.#.#.#.#
###.#.###.#.#.#.#
#.#.#...#...#.#.#
#####.#.#.#.#####
#...#.#.#.#.....#
#.#.#####.#.#####
#.#.....#.......#
#.###.#.#.#.#.#.#
#...#.#.#...#.#.#
#.#.#####.#.#####
#.#.....#.#.....#
#.###.#.###.#####
#...#.#....E....#
###.###########.#
#.#...........#.#
#################
