#################
#.......#..E#...#
#.###.#####.#.###
#...#.#...#...#.#
#.###.#.###.###.#
#.#.............#
#.###.#######.#.#
#...#...#.#.#.#.#
#.###.###.#.#.#.#
#...#S#.....#.#.#
###.#######.#####
#.....#.#.#.....#
###.###.#.###.###
#...#.........#.#
#.###########.#.#
#.....#...#...#.#
###.###.###.###.#
#...........#...#
###.#.#.###.###.#
#...#.#.#.#.#.#.#
#.#####.#.###.#.#
#...#.#.#...#...#
#####.#.#.#.#.#.#
#.........#...#.#
#.###.###.#.###.#
#.#...#...#.#...#
#.#####.#########
#.....#.....#.#.#
#.#.###.###.#.#.#
#.#...#.#.......#
#################
