#################
#S......#.......#
#####.#.#####.###
#.....#.#.......#
###.###.#.###.###
#...#...#...#...#
#.###.#.#.#.#.#.#
#...#.#.#.#.#.#.#
#####.#.###.#####
#.....#.......#.#
###.#.#####.###.#
#...#.#...#.....#
###.#####.#######
#.....#.........#
#####.#######.#.#
#.....#.#.....#.#
###.###.###.#.###
#.#...#.....#...#
#.#.###.#########
#E#.#...#.....#.#
#.#.#.###.#.###.#
#.#.....#.#.#...#
#.#.#######.#.#.#
#.#.......#...#.#
#.#.#.###.###.###
#...#...#.#.#.#.#
#.#.#.#.###.#.#.#
#.#.#.#.......#.#
#.#############.#
#...............#
#################
