#################
#...#.....#.....#
#.#.#.###.#.###.#
#.#...#.#...#...#
#.#####.#.#####.#
#.#...#...#S..#.#
#.#.#.#.#####.###
#.#.#.#.#...#...#
#.#.#.###.#.###.#
#...#.....#...#.#
#.#########.#.#.#
#.#.#.....#.#.#.#
#.#.#.###.#.#.#.#
#...#...#...#.#.#
###.###.#######.#
#.#.#.#.#.....#.#
#.#.#.#.#.###.#.#
#.#.#.#...#.#...#
#.#.#.#####.#####
#...#...........#
#.#####.#####.#.#
#.....#.....#.#.#
#####.###.###.#.#
#.#...#...#..E#.#
#.#.###.###.###.#
#.#.#...#.#...#.#
#.#.#.###.###.#.#
#...#.....#...#.#
#.#########.###.#
#...........#...#
#################
