#################
#.........#.#...#
#.###.#.###.###.#
#.#...#.#...#...#
#.#.#.#####.#.###
#.#.#.......#...#
#.#.###.#.#.#.#.#
#.#.#.#.#.#.#.#.#
#####.###.#.###.#
#.#.......#.#...#
#.#.#.###.#.#.###
#...#.#...#.#...#
#######.#.#.###.#
#...#.#.#.#.....#
#.#.#.#.#########
#.#...#...#.....#
###.#####.#.#####
#...#.#.........#
#.#.#.###.###.#.#
#E#.........#.#.#
#.#.#.#.#.#.#####
#.#.#.#.#.#...#.#
#.###.###.#.###.#
#...#...#.#.#...#
###.#########.###
#.......#.....#S#
#.###.#.#.#.###.#
#.#...#...#.....#
#.#####.#.###.###
#...#...#.#.....#
#################
