#################
#...............#
#.###.#.#######.#
#...#.#.......#.#
#.#.###.#.###.#.#
#.#...#.#...#.#.#
#.###.#.#########
#S..#.#.........#
#.###.#######.#.#
#...#.......#.#.#
#.#.#.#.#####.#.#
#.#.#.#.....#.#.#
#####.#.#########
#...#.#.........#
#####.#.#########
#...#.#.........#
#####.#.#.#.#####
#...#.#.#.#.....#
#.#.###.#.#.#.#.#
#.#...#.#.#.#.#.#
###.#.#.#.#.###.#
#.#.#.#.#.#...#.#
#########.#.#.###
#.......#.#.#...#
#####.#.#.#.###.#
#...#.#.#.#...#.#
#######.#.###.#.#
#.....#.#...#.#.#
#.#.#####.#.#####
#.#.....#E#.....#
#################
