#################
#...........#...#
#######.###.###.#
#.......#...#...#
#.#######.###.#.#
#...#.......#.#.#
#.#.#######.#.#.#
#.#.....#.#...#.#
#.#####.#.#####.#
#.#.....#.#.....#
#.#.#####.#.#####
#.#.#.#.....#...#
###.#.#.#######.#
#...#...........#
#.###.###########
#.#...#...#.....#
#.#####.#.#.###.#
#.......#.#.#.#.#
#.#######.#.#.#.#
#.#.#...#.....#.#
#.#.#.#.#######.#
#.#E..#.#...#...#
#.#.###.#.#.#.#.#
#.#.#...#.#...#.#
#.###.###.#####.#
#.....#...#..S#.#
#######.###.###.#
#.......#...#.#.#
#.#######.###.#.#
#.........#.....#
#################
