###################
#.................#
###.###.#.#.#.#.###
#.#...#.#.#.#.#...#
#.#####.#########.#
#..............E#.#
###.#.#.###.#######
#.#...#...#.......#
#.###.#.#.#####.#.#
#...#S#.#.....#.#.#
#######.#.#######.#
#.....#.#.......#.#
#.#.#.###.###.#####
#.#.#...#...#.....#
###.#####.#.#.#####
#.#.....#.#.#.....#
###################
