###################
#.................#
#.#.#.###.###.###.#
#.#.#S..#...#...#.#
#.#.###.###.#####.#
#.#...#...#.....#.#
###.###.#.#########
#.#...#.#.........#
#.#####.###.#.#.#.#
#.....#...#E#.#.#.#
#######.#.#.#######
#.....#.#.#.......#
#.###.#.#########.#
#...#.#.........#.#
###.#.#.###.###.###
#.#.#.#...#...#...#
###################
