###################
#.#...#.......#...#
#.#.#.#.#.###.###.#
#...#...#.#.#.....#
#.#######.#.#####.#
#.#...#..E#...#...#
###.#.#.###.###.###
#...#...#...#...#.#
#.#######.###.###.#
#.#...#.....#.....#
#.#.#.#.###.#####.#
#.#.#...#...#.....#
#.#.#####.#.#.#####
#.#...#...#.#...#.#
#.#####.###.###.#.#
#.....#.#...#...#.#
#.###.#.#####.###.#
#...#S#...........#
###################
