###################
#.......#.#.......#
###.#####.#.#.#.#.#
#.#.........#.#.#.#
#.#.#####.#####.###
#.....#.......#...#
#######.#.#.#####.#
#.......#.#.#.....#
###.#######.#.#####
#...#...#.#.#...#.#
###.#.###.#####.#.#
#S#...#.....#..E..#
#.#.#.###.#.###.#.#
#...#.#...#.....#.#
###################
