###################
#S......#...#.....#
#####.#.#.#.#####.#
#...#.#.#.#.#...#E#
#.###.#.###.#.#.#.#
#...#.#.#.#...#...#
###.###.#.#.#.#####
#.....#.#...#.#...#
###.#.#.#.#.#.#.#.#
#...#.....#.#.#.#.#
#########.###.#.###
#.......#.#.#.....#
#####.#.#.#.###.###
#.....#.......#...#
###################
