###################
#S................#
#.#####.###########
#.....#...........#
#.###.#.###.#.#.#.#
#...#.#...#E#.#.#.#
###.#.#####.#.###.#
#.#.#.....#.#...#.#
#######.#.#.###.#.#
#.....#.#.#...#.#.#
###.#.#.#.#######.#
#.#.#.#.#.......#.#
###################
