###################
#.....#.......#...#
#.###.#.#####.#.#.#
#.#.#.....#...#.#.#
#.#.#######.###.#.#
#...#...#...#...#.#
###.#.###.###.###.#
#.#...#S..#.....#.#
#.###.#####.###.###
#.#...#.#.....#...#
#.#.###.#.#######.#
#...#.......#.....#
#.###.#######.#####
#.#...#.....#.#...#
#.#####.###.#.#.#.#
#.#...#...#.#...#.#
#.#.#.###.#.#####.#
#...#.....#....E..#
###################
