###################
#...#...#.........#
#.#.#.#.#.#######.#
#.#.#.#.#...#..E#.#
#.###.#.###.#.#.#.#
#...#.#...#...#.#.#
#.#.#.#.#######.#.#
#.#.#.#.....#...#.#
#.#.#.###.###.###.#
#.#.....#.#...#...#
#########.#.###.#.#
#......S#...#...#.#
#.#########.#.###.#
#...#.....#.#...#.#
###.#.###.#####.#.#
#.#...#.#...#...#.#
#.#####.###.#.###.#
#.............#...#
###################
