###################
#.................#
#.#.#####.#.#.#.#.#
#.#E....#.#.#.#.#.#
#.#.#.#.#######.#.#
#.#.#.#.......#.#.#
#.#.###.###.#.###.#
#.#...#...#.#...#.#
#.#.#.###.###.###.#
#.#.#...#S..#...#.#
#####.###.#########
#...#...#.........#
###################
