###################
#.................#
###.#.#.###.#.#.###
#.#.#.#...#.#.#...#
#######.###.###.#.#
#.....#...#...#.#.#
#.#.###.#####.###.#
#.#...#.....#...#.#
#.#.#.###.#.#.#.#.#
#.#.#..........S#.#
###.#.#.#.#.#####.#
#.#.#..E#.#.....#.#
#.###.###.#.###.###
#...#...#.#...#...#
###################
