###################
#..........E......#
#.#######.#.#.#####
#.......#.#.#.....#
#.###.###.#.#.###.#
#...#...#.#.#...#.#
#.#######.#.#######
#.......#.#.......#
#.#.#.###.###.###.#
#.#.#...#...#...#.#
#.###########.#.#.#
#S..........#.#.#.#
###################
