###################
#S#.........#E....#
#.#.#####.#.#.#.###
#.#.#...#.#.#.#.#.#
#.###.###.#.#.###.#
#.#...#...#...#...#
#.#.###.###.#.#.###
#.#...#.#.#.#.#.#.#
#.#.#####.###.#.#.#
#.................#
###################
