###################
#.................#
#.#.#.#.#####.#.#.#
#S#.#.#.....#E#.#.#
#.###.#####.#.#.#.#
#...#.....#.#.#.#.#
###.#.#.###########
#.#.#.#...........#
#####.#.#.#.#.#.###
#...#.#.#.#.#.#...#
#.#.#.#####.#.#.#.#
#.#.#.....#.#.#.#.#
#######.#######.#.#
#.....#.......#.#.#
###################
