###################
#........E........#
#.#####.#####.#.###
#S....#.....#.#...#
#.#.#####.#.#######
#.#.....#.#.......#
#.###########.#.#.#
#...........#.#.#.#
#####.#######.#.###
#...#.......#.#...#
###################
