###################
#...#...#...#.....#
###.#.###.###.#.#.#
#.#.....#.....#.#.#
#.#####.#.###.###.#
#.....#.#.#.#.#...#
#####.#.#.#.#.###.#
#...#...#.#...#.#.#
#.###.###.#####.###
#.....#.#E....#...#
###.###.###.###.#.#
#...#.......#.#.#S#
###.#.###.#.#.#.###
#.......#.#.......#
###################
