###################
#.....#E..........#
#.#####.#.#.#######
#.#.#...#.#.......#
#.#.#.#######.#.#.#
#...#.....#...#.#.#
#.###########.###.#
#.......#.....#S#.#
###.###.###.###.#.#
#...#.#.#.......#.#
#.###.#.#.#########
#.#...#...#.......#
###.#.#.#####.#.###
#.#.#.......#.#...#
#.#.###.###.###.###
#...#...#.........#
#.###.#####.#.#.#.#
#.#.......#.#.#.#.#
###################
