###################
#.....#...#.......#
#.###.#.###.#####.#
#.#.#.#.....#.#...#
#.#.#.#.#####.#.#.#
#.#.#.#......E#.#.#
#.#.#.#.#######.#.#
#.#.#S#.#.......#.#
#.#.#####.#######.#
#.#.......#.....#.#
#.#.#######.#####.#
#...#.............#
###################
