###################
#.#...#.......#...#
#.#.#.#.#####.#.#.#
#...#.......#...#.#
#.#######.#######.#
#.#.....#.#...#...#
#.#.###.###.#.#.#.#
#.#...#.#...#...#.#
#.###.#.#.#######.#
#...#S#...#......E#
###################
