###################
#.......#....E#...#
#.#.#####.#.#.#.#.#
#.#.#.....#.#...#.#
#.###.#####.#####.#
#.#...#...#.#...#.#
#.#.###.###.#.###.#
#.#...#.#S#.#...#.#
#.###.#.#.#.#.#.#.#
#.......#...#.#...#
###################
