###################
#E.........S......#
#.#.#.#.#####.#.###
#.#.#.#.....#.#...#
#.#####.#####.#.#.#
#.....#.....#.#.#.#
###.#####.#.#.#.#.#
#.#.....#.#.#.#.#.#
#.#.###.#####.#.###
#.#...#.....#.#...#
###################
