###################
#.................#
#.#.#.#.#.#########
#.#.#.#.#.........#
#.###.#.#.###.###.#
#...#.#.#...#...#.#
#####.#.#####.#.###
#...#.#.....#.#...#
#########.#.###.###
#.......#.#...#...#
#########.#.#.#.#.#
#.......#E#.#.#.#.#
#.#.#####.#.#.#.#.#
#.#.....#.#.#.#.#.#
#.#.#.###.###.#####
#.#.#...#...#..S..#
###.###.###.#.###.#
#.#...#...#.#...#.#
###################
