###################
#...#.#...#.#....S#
#.###.#.###.#.#####
#.....#.....#.#...#
#.#####.###.#.#.###
#.......#.#.....#.#
#.#####.#.#.#####.#
#.#.....#.......#.#
#.#.#.#.#.#.###.#.#
#.#.#.#.#.#.#.....#
#.#####.###.#######
#..E#.#.#.#.#.....#
#####.#.#.#.#.#.#.#
#.#.....#.....#.#.#
#.#.#.#####.#######
#...#...#.........#
#.#######.#.#.#.#.#
#...#.....#.#.#.#.#
###################
