###################
#.................#
#.#.###.###########
#.#...#...........#
###.#############.#
#.#.............#.#
#.#.#.#.#.###.###.#
#S#.#.#.#...#...#.#
#.#######.###.###.#
#.......#...#...#.#
#.#####.#####.#.###
#.....#....E#.#...#
###.###.###.#.#.#.#
#.#...#...#.#.#.#.#
#.###.#############
#...#.............#
#.#.#.#########.###
#.#.#.........#...#
###################
