###################
#S#.......#...#...#
#.#####.###.#.#.###
#.#.........#.....#
#.#######.#.#####.#
#.#.#.#.#.#.....#.#
#.#.#.#.#######.###
#....E............#
#.#.###.###.###.#.#
#.#...#.#...#.#.#.#
#.#.###.#####.#####
#.#...#...#.......#
#####.###.#.###.#.#
#.......#...#.#.#.#
###.#########.#.###
#...#.............#
###################
