###################
#.................#
###.#.#.#.###.#.#.#
#.#.#E#.#...#.#.#.#
###.###.#.#####.#.#
#.#...#.#.....#.#.#
###.#.###.#.###.#.#
#.#.#...#.#...#.#S#
#######.###.###.#.#
#.....#...#...#.#.#
#.#.#.#.#.#.###.#.#
#.#.#.#.#.#...#.#.#
###.#.#.###.#######
#.#.#.#...#.......#
#.###.#.###########
#...#.#...........#
###################
