###################
#.....#...#.#.....#
#####.#.#.#.#.###.#
#...#.#.#.#.#.#...#
#.#.#.#.#.#.#.#.#.#
#.#...#.#S#.#.#.#.#
#.#####.###.#.#.#.#
#.#...#.#.....#.#.#
#.#.#.#.#.#####.#.#
#E#.#...#...#...#.#
#.#.#######.#.#####
#...#.....#.#.....#
#.#####.#.#######.#
#...#...#.....#...#
###.#.#######.#.#.#
#.....#.........#.#
###################
