###################
#...#.#...........#
###.#.#####.###.###
#..E#...#.#.#.#...#
#.#.#.###.#.#.#.###
#.#...........#.#.#
#.#######.#####.#.#
#.#...#.#.#...#...#
#.#.###.#.###.#.#.#
#....S#.....#...#.#
###################
