###################
#.............#...#
#.#.#.#######.#.#.#
#.#.#.#...#.#...#.#
#.#.###.#.#.#####.#
#.#...#.#.#.#...#.#
#.###.#.#.#.#.#.#.#
#...#...#.#...#.#.#
#.#####.#.#####.#.#
#.#...#.#E#.....#.#
###.#.###.#.#####.#
#S..#.....#.......#
###################
