###################
#...#...#.....#...#
#.#.#.#.#.#.###.#.#
#.#...#...#..E..#.#
#.###############.#
#...#.#.....#.....#
###.#.#.#.###.###.#
#.#.#...#...#.#...#
#.#.#####.#.#.#.###
#...#...#.#.#.#.#S#
#.###.#.###.#.###.#
#.#...#.....#.....#
#.#.#.#####.#######
#.#.#.#...#.....#.#
#.###.#.#.#####.#.#
#.....#.#.........#
###################
