###################
#.................#
#.#.#.#.###.#####.#
#E#.#.#...#.....#.#
#####.#.###########
#...#.#...........#
#####.#.#.###.#.#.#
#...#.#.#...#.#.#.#
#########.###.#.#.#
#.......#...#.#.#.#
#.###.###.#.#.#####
#...#...#.#S#.....#
#.#.###.#######.###
#.#...#.......#...#
###################
