###################
#...........#.#...#
#.#######.###.#.###
#.....#...#.......#
#.#########.#######
#...#...#.#E......#
###.#.###.###.#####
#.....#...#...#...#
#.#######.#.###.#.#
#...........#...#S#
###.#######.#.#####
#...#.#.#.#.......#
#.#.#.#.#.#.#.#.###
#.#.....#...#.#...#
#.###.#.#.#.#.#.###
#.#...#.#.#.#.#...#
###################
