###################
#.........#.#...#.#
#.###.###.#.#.#.#.#
#.#.#.#...#.#.#...#
#.#.#.#.###.#.###.#
#...#.#.#...#.#.#.#
#####.#.###.#.#.#.#
#.....#.....#S#...#
#.#########.###.###
#.#.......#...#.#.#
#.#.#####.#####.#.#
#.#.#...#.#...#.#.#
#.#.###.#.#.#.#.#.#
#.......#E..#.....#
###################
