###################
#.#.......#S..#...#
#.#.#.###.###.#.#.#
#...#...#...#...#.#
#.#####.#########.#
#.#...#...........#
#.###.#############
#.......#.......#.#
#######.#.###.#.#.#
#.#.....#.#...#.#.#
#.#.#####.#.###.#.#
#.#.#.....#.#.#.#.#
#.#.#######.#.#.#.#
#...........#E....#
###################
