###################
#...#.#.....#....S#
###.#.#.#####.#####
#...#.#.#.....#...#
#.###.#.#####.###.#
#.........#.......#
#########.###.###.#
#.#.......#...#...#
#.#.#######.#####.#
#..........E..#...#
###.#####.#######.#
#.....#...#.......#
###################
