###################
#.....#S#.......#.#
#.###.#.#######.#.#
#.#...............#
###.#####.#######.#
#.......#...#.#.#.#
#.#######.###.#.###
#...#.#...........#
###.#.#####.#.#.#.#
#...#...#...#.#.#.#
#.#####.#.###.###.#
#.#.........#.#.#.#
#.#.#####.#.#.#.###
#.#...#.#.#.#.....#
#.#####.#####.#####
#.#.......#.......#
#.###.###.#.#####.#
#.#.....#.....#E..#
###################
