###################
#.................#
#.#.#########.###.#
#.#.........#...#.#
#.#####.#####.#.#.#
#.....#.....#.#.#.#
#.#.#.#####.#.#.#.#
#.#.#.....#.#.#.#.#
#.#######.#######.#
#..............E#.#
#.#####.#######.###
#.....#.......#...#
#.#.#.###.#.#.#.###
#.#.#...#.#.#.#...#
#.###.#######.#.###
#...#.......#.#...#
#.###.#####.#.#####
#S..#.....#.#.....#
###################
