###################
#.........#....E..#
#.#.#####.###.#####
#.#.#S..#...#.....#
###.###.###.#####.#
#.....#...#.......#
#.###.###.#######.#
#.#...#...#.....#.#
#.#####.###.#.#.#.#
#...#...#...#.#.#.#
###.#.#######.###.#
#.#...#.......#...#
#.#####.#######.###
#.................#
###################
