###################
#.#.#...#.....#...#
#.#.###.#.###.#.###
#....S#.....#.....#
###.#####.#########
#.#...#...#...#...#
#.###.###.###.###.#
#...#.......#E#...#
#.#.#######.#.#.###
#.#.........#.....#
#.#.#####.###.#.###
#.#.#.....#.#.#...#
#######.###.#####.#
#.....#.#.#.....#.#
#####.#.#.#.###.#.#
#...........#.....#
###################
