###################
#.............#...#
#.#####.#####.###.#
#.....#.....#.....#
#####.#########.###
#.............#.#S#
#.#.#######.#.#.#.#
#.#.#....E#.#.#...#
#.###.#.#.###.#.###
#.....#.#...#.#...#
###################
