###################
#............E#...#
#.###.#.#.#.###.###
#.#...#.#.#.#.....#
###.###.###.#.###.#
#.....#.#...#.#...#
###.#.#####.#.###.#
#...#.#.....#.#...#
#.#######.#.###.#.#
#.#.......#...#.#.#
#.#########.#.#.###
#..S#.......#.....#
###################
