###################
#.....#.#...#.#.#.#
###.#.#.#.###.#.#.#
#.#.#.....#.#.#.#.#
#.#.#######.#.#.#.#
#.#.........#.#...#
#.#.#####.#.#.###.#
#.....#.#.#E..#...#
#.#.###.#.###.#.###
#.#.#.#...#...#...#
#.###.###.#.#.#.###
#..S#.....#.#.....#
###################
