###################
#.....#...#.......#
#.###.#.#.#.#####.#
#...#.#.#.#.....#.#
#.#.###.#.#.###.###
#.#.#S#.#.#...#...#
###.#.#.#.###.###.#
#...#...#...#.#...#
#.#########.###.#.#
#.........#.#...#.#
#########.#.#.#####
#.........#.#.....#
#.#######.#.#####.#
#.....#...#...#...#
#.###.#.#####.#.###
#.#...#.#.....#...#
###.###.#.#######.#
#...#.#.#.#.......#
#.###.#.#.###.#.###
#...#...#...#E#...#
#.#.#######.#####.#
#.#...............#
###################
