###################
#.................#
#######.###.#.#.#.#
#.....#...#.#.#.#.#
#.#.#####.#########
#.#.....#.........#
#.#.#.###.#.#####.#
#.#.#...#.#.....#.#
###.#.###.###.#####
#.#.#......S#.....#
#.###.#.#.#.#.#####
#.....#.#.#.#.....#
#.###.#####.#######
#...#.....#.......#
#.###.#.#######.###
#...#E#.......#...#
#########.#######.#
#.......#.......#.#
###.###########.###
#.#...........#...#
#######.#.###.#.#.#
#.....#.#...#.#.#.#
#.#######.#.#######
#.......#.#.......#
###################
