###################
#.................#
#.#.#############.#
#.#...#...#.....#.#
#.###.#.#.#.###.#.#
#.#.#.#.#...#...#.#
#.#.#.#.#####.###.#
#...#...#...#.#.#.#
###.#####.###.#.#.#
#.#.#.....#...#...#
#.#.#.#####.#######
#.#...#...#.......#
#.###.#.#.#######.#
#.....#.#.......#.#
#.#####.#######.#.#
#.#.....#...#.....#
#.#.#.###.#.#####.#
#.#.#E#...#.#...#.#
#.#.###.###.#.#.#.#
#.#...#.#...#.#.#.#
#.###.#.#.#.#.#.#.#
#...#...#.#.#.#S#.#
###.#####.###.###.#
#.......#.....#...#
###################
