###################
#.......#...#...#.#
###.#####.#.###.#.#
#.........#.#.#...#
###.#.#####.#.#.#.#
#...#.#.#.#.....#.#
#.###.#.#.#####.#.#
#...#.........#.#.#
#.#.###.###.#.#####
#.#.#...#...#.....#
###.#.#######.#####
#...#.....#.....#.#
###.#.#.#####.###.#
#...#.#.#.........#
#######.#######.#.#
#.....#.#.....#.#.#
#.#.#######.###.###
#.#...............#
#.#####.#######.#.#
#...#.....#...#.#.#
#.#.#########.#.###
#.#.#.....#.....#.#
###.###.#########.#
#.#...#...........#
#.#.###.#######.#.#
#...........#...#.#
#######.###.#.#####
#E........#.#....S#
###################
