###################
#.....#...#.#.....#
###.#.#.###.###.#.#
#...#.#...#.....#.#
#####.#.#.#.#.###.#
#...#.#.#...#.#...#
#.#.#.#.#.###.#####
#.#...#.#...#.#...#
###.#####.#####.#.#
#.#.#.......#...#.#
#.#.#.###.#.#####.#
#...#.#.#.#.#.....#
###.#.#.###.#####.#
#.....#.#.#..E#...#
#######.#.#.###.###
#.#.....#...#.#.#.#
#.#.#######.#.#.#.#
#.....#.#.........#
#.###.#.###.#.#.#.#
#.#.#.....#.#.#.#.#
#.#.###.#.#######.#
#.#.....#.#.......#
#.#.#.#####.#####.#
#.#.#..........S#.#
###################
