###################
#.................#
#.###.###.#########
#...#..S..........#
#####.###.#.#.#####
#...#...#.#.#.....#
#######.#.###.#.#.#
#.....#.#...#.#.#.#
#.#.#####.###.###.#
#.#.........#...#.#
#########.###.#.#.#
#...........#.#.#.#
#.#######.#.#######
#.......#.#.......#
#.###.###.#.#####.#
#...#.....#.....#.#
###.#####.#.#######
#.#.....#.#.......#
###.#.#.#.#.#####.#
#.#.#.#.#E#.....#.#
#.#####.#######.#.#
#.....#.......#.#.#
###.#######.#.###.#
#.#.......#.#...#.#
#.###.#############
#...#.............#
#.#######.#.###.#.#
#.......#.#...#.#.#
###################
