###################
#...........#.#..S#
#####.#####.#.#.###
#.#E....#...#.....#
#.#.#######.#.#####
#.#.....#.....#...#
#.#######.#.#.#.###
#.#.#.#...#.#.....#
#.#.#.###.#.#.###.#
#.......#.#.#...#.#
#.#####.#.###.###.#
#.#.......#...#...#
#.#########.#######
#...#...#...#...#.#
###.#.#####.###.#.#
#...#.#...#.#.....#
#.###.#.###.#####.#
#.......#.........#
#.#########.#.###.#
#.#.....#.#.#...#.#
#######.#.#######.#
#...#.#.#.........#
#.#.#.#.###.###.###
#.#.........#.....#
###################
