###################
#...#.............#
#.#.#.###########.#
#E#.#.#.......#...#
#.###.#.#####.#.###
#...#.#.#...#.#...#
#.#.#.#.#.#.#####.#
#.#...#...#.....#.#
#.#########.#.###.#
#.#.......#.#...#.#
#.#.###.#.#####.#.#
#.#.#...#.......#.#
#.#.#.###.#####.#.#
#.#.#...#.#S#...#.#
#.#####.###.###.#.#
#.....#...#...#.#.#
#####.###.###.###.#
#...#...#...#.#...#
#.#.###.###.#.#.#.#
#.#.........#...#.#
###################
