###################
#.....#.#.....#.#S#
#.#.###.#.#####.#.#
#.#...#.....#...#.#
###.#####.#.#.###.#
#.#...#...#.#...#.#
#.###.#.#####.###.#
#..E#.#.#...#.....#
#.#.#.#.#.#.#####.#
#.#.#.....#...#...#
#.#.#.#####.#####.#
#.#.#...#.#.......#
#.###.#.#.#####.###
#...#.#.#.........#
#.###.#####.###.###
#.........#.#.....#
#######.#.#.#######
#.#.#...#.#.......#
#.#.#####.#.#######
#.........#.#.....#
#.###.###########.#
#...#...#.......#.#
#.###.#####.#.###.#
#...#.....#.#.....#
###.#.###.#.#.#####
#...#.#.....#.....#
###.###########.###
#...#.............#
###################
