###################
#.#.....#.........#
#.#.###.#.###.###.#
#.#...#...#...#...#
#.###.#####.#######
#..E#...#.#.......#
###.###.#.#######.#
#.....#.........#.#
#.###.#########.#.#
#.#...........#.#.#
#.###.#########.#.#
#...#.#.........#S#
#.#.###.###########
#.#.#...#.........#
#.#.#.#####.#.#####
#.#.#.#...#.#.....#
###.#.#.#.#.#####.#
#...#...#.#...#.#.#
#.#######.###.#.#.#
#.....#...#.....#.#
#.###.#.#########.#
#...#.............#
###################
