###################
#.................#
#.#.#.#.###.#.#.###
#.#.#.#...#.#.#...#
###.#####.#.#######
#.#.....#.#.......#
#.#.#.###.###.#####
#.#.#...#...#.....#
#.###.#######.#.#.#
#...#.......#.#.#.#
#.#.#.###.###.#####
#.#.#...#...#.....#
#.#####.###.###.#.#
#.....#..E#...#.#.#
#####.###.#########
#...#.............#
#.###.###.#.#######
#...#.....#.......#
#####.###.###.###.#
#...#.......#...#.#
#.#####.#.#########
#.....#.#.........#
#########.###.#####
#.......#...#.....#
#.###.#.#.###.#.#.#
#...#.#.#...#.#.#.#
###.#.###.#####.###
#.#.#...#S....#...#
###################
