###################
#...#S#...#.......#
#.###.#.#.#####.#.#
#.#...#.#.....#.#.#
#.#.###.#####.#.#.#
#.#.....#.#...#.#.#
#.#######.#.###.#.#
#.........#.#...#.#
#.#########.#.#.###
#...........#.#...#
#.###############.#
#.#.............#.#
#.###.#########.#.#
#.....#...#...#...#
#########.#.#.###.#
#.#.......#.#.....#
#.#.#.#####.#######
#.#.#.#...#.#.....#
#.#.#.#.#.#.#.###.#
#.#.#E#.#.#...#.#.#
#.#.#.#.#.#####.#.#
#...#.#.#.#...#...#
#.###.#.#.#.#.#.###
#.#.#...#...#.#...#
#.#.#########.###.#
#...........#.....#
###################
