###################
#S................#
###.#####.###.###.#
#.#.....#...#...#.#
###.#.#####.#.###.#
#...#.....#.#...#.#
###.#####.#.#.#####
#.......#.#.#.....#
###.#.#####.#.###.#
#.#.#.....#.#...#.#
#.#.#.###.#.###.###
#.#.#...#.#...#...#
#.#.#######.#.#.#.#
#.#.......#.#.#.#.#
###.#.###.#####.###
#.#.#...#.....#...#
#.#.#.#.###########
#.#.#.#...........#
###.#####.#.#.#####
#.#E....#.#.#.....#
###.#.#######.#.#.#
#.#.#.......#.#.#.#
###.#.#.#.#####.#.#
#.#.#.#.#.....#.#.#
###.#.#.#######.#.#
#.#.#.#.......#.#.#
###################
