###################
#.#.........#.....#
#.#.#######.#####.#
#.#S#.....#...#...#
#.###.###.###.#.#.#
#...#.#.#...#.#.#.#
#.###.#.#.#.#.#.#.#
#...#.#.#.#.#...#.#
###.#.#.#.#######.#
#...#.#.#...#.....#
#.###.#.###.#.#####
#.#...#...#...#...#
#.#.###.#.#####.#.#
#...#...#.....#.#.#
#.###.#######.###.#
#.....#.....#...#.#
#######.###.###.#.#
#E......#.#...#...#
#.#####.#.###.###.#
#.#...#.#.....#...#
#.#.#.#.###.###.###
#.#.#.#...#...#.#.#
#.###.###.#####.#.#
#.......#.....#...#
#######.#####.###.#
#...........#.....#
###################
