###################
#...........#E....#
#######.###.#####.#
#.......#.#...#...#
#.#######.###.#.###
#.#...........#...#
#.#########.#####.#
#.........#.......#
###.#####.###.#####
#S#.....#.#...#...#
#.#####.#.#.###.#.#
#...#...#.#.#...#.#
###.#.###.###.###.#
#.#.#...#.......#.#
#.#.###.#########.#
#...#...#.......#.#
#.#######.#####.#.#
#...#...#.#...#...#
###.#.#.#.#.#####.#
#.....#...#.......#
###################
