###################
#.#.#...#.#.......#
#.#.#.###.#####.###
#.#.#.....#.....#.#
#.#.#.#.#######.#.#
#.....#.....#...#.#
###.###.#####.###.#
#....E#.#.#.......#
#.#######.#.#######
#...........#.....#
#.###.#########.#.#
#.#.........#...#.#
#.###.#######.#####
#.#.#.......#.....#
###.#.#.#.#.###.#.#
#.....#.#.#.#...#.#
#.###.#####.#.#####
#.#.....#...#.#...#
###.#########.###.#
#S......#...#.....#
#####.#.#.#.#####.#
#.....#...#.......#
###################
