###################
#.....#...........#
#.#.#####.#######.#
#.#.#.......#...#.#
#.#####.#####.#####
#...#.#.......#...#
###.#.#####.###.#.#
#...#.#.........#.#
###.#.#.#.###.#####
#.......#...#.#...#
#.#.###.###.###.###
#.#.#.....#.......#
###.#####.#.#.#####
#.......#.#.#.#...#
#.#####.#.###.###.#
#.#...#.#...#.....#
#.###.#####.#####.#
#.#.....#.....#.#.#
#####.#.###.###.#.#
#E....#.........#.#
###.#######.###.###
#.......#...#S....#
###################
