###################
#.#...........#...#
#.#######.###.###.#
#E#.#.......#.#.#.#
#.#.#.#.#####.#.#.#
#.#...#.#...#.....#
#.#####.#.#####.#.#
#.#.#.....#.....#.#
#.#.#.###.#.#######
#...#...#S#.#.....#
#.#####.###.#####.#
#.........#.#...#.#
#####.###.###.###.#
#...#.#.#.........#
#.#.#.#.#.###.#####
#.#.....#.#.#.....#
#.#.#####.#.###.#.#
#.#.#...#.#.#.#.#.#
#.#####.#.#.#.#####
#.#.#.#...........#
#.#.#.###.#######.#
#.#.......#...#...#
#.###########.#.#.#
#...#...........#.#
#.#####.#.#.#.###.#
#...#...#.#.#.#...#
###################
