###################
#...#.......#.....#
#.###.#####.#.#####
#.#...#.....#.....#
#.#.###.#########.#
#...#.#...#.......#
#.###.###.#.#.#####
#...#...#S#.#.....#
###.###.#########.#
#.#...#...........#
#.###.#.#########.#
#...#.#.#.........#
###.#.#.#.#########
#...#...#...#.....#
#.#########.#.#####
#.......#...#.....#
#.#####.#.###.###.#
#...#.#...#.....#.#
###.#.###########.#
#............E....#
###################
