###################
#.#.....#.........#
#.#####.#.#######.#
#.......#.#.......#
#####.###########.#
#.#.......#S#.#.#.#
#.###.###.#.#.#.#.#
#.....#...#...#...#
#######.#####.#.#.#
#...#.....#...#.#.#
#.#.###.#####.###.#
#.#.#.....#.....#.#
###.#.#######.###.#
#.#...............#
#.#.###.###.#######
#.....#.#.#.......#
#.#######.#.#######
#.#.......#.....#.#
###.#########.###.#
#.....#.........#.#
#.#.###.#.#.#####.#
#.#...#.#.#...#...#
###.#####.#.###.###
#.......#.#E#.....#
#.#.###.#.#.###.###
#.#.#.....#.......#
###################
