###################
#.................#
###.#.#.###.#####.#
#.#.#.#...#.....#.#
#.###.#.###########
#...#.#E..........#
###.#.#.#.#.#.#.#.#
#.#.#.#.#.#.#.#.#.#
#.#######.#.#.#####
#.......#.#.#....S#
#.#.###.###.#.###.#
#.#...#...#.#...#.#
###.#####.#####.#.#
#.#.....#.....#.#.#
#.#.#.###.#.#.#.#.#
#.#.#...#.#.#.#.#.#
#.###.###.#.###.###
#...#...#.#...#...#
###.#.###.#.#######
#.#.#...#.#.......#
###################
