###################
#.....#.....#.....#
#.###.###.#.#.#.###
#...#...#.#.#.#...#
#.#.###.#.#.#####.#
#.#.#.....#.......#
#.#.#############.#
#.#...#.........#.#
#####.###.#######.#
#S..#...#.....#...#
###.#.#.#####.#.###
#.#.#.#...#...#...#
#.#.#####.#.#####.#
#...#.....#....E#.#
#.###.#####.#.###.#
#...#.#...#.#.....#
###.#.###.#.#######
#...#...#.........#
#.#####.#########.#
#.#...#.#...#...#.#
#.#.#.#.#.#.#.#.#.#
#...#.#...#...#.#.#
#####.#####.###.###
#...#.....#...#...#
#.#######.#######.#
#.......#.........#
#.#####.#########.#
#.....#...........#
###################
