###################
#..S#.#...#.#.....#
#.###.#.#.#.#####.#
#.......#.....#...#
#######.###.#####.#
#.....#.#...#...#.#
#####.#####.#.###.#
#.....#.#.#.#.....#
#####.#.#.#.#####.#
#...#.........#...#
###.#.###.###.#.#.#
#.#.....#.#.#...#.#
#.#.#######.#####.#
#.#.#.....#...#...#
#.#.#.#######.#.#.#
#...#.....#...#.#.#
#.#######.#.#.#.###
#.#.#.#.....#.#.#.#
#.#.#.#.###.#.#.#.#
#.#.#...#...#..E..#
#.#.#####.###.#####
#.#.......#.......#
###################
