###################
#.................#
###.###.###.###.###
#.#...#...#...#..S#
#.#.#.#.#####.#.###
#.#.#.#.....#.#...#
#.#.#.#.#.#.#.#.###
#.#.#.#.#.#.#.#...#
###.#.#.#######.###
#.#.#.#.......#...#
#.#.#####.#.###.###
#.#.....#.#...#...#
#.#.#.#####.#.###.#
#.#.#.....#.#..E#.#
###.#.#########.#.#
#.#.#.........#.#.#
#####.#####.#.#.#.#
#...#.....#.#.#.#.#
###.#####.###.#.#.#
#.#.....#...#.#.#.#
#####.#.#######.###
#...#.#.......#...#
###################
