###################
#.................#
###.#.#####.#.###.#
#.#.#.....#.#...#.#
###.###.###.#.#.###
#.#S..#...#.#.#...#
#.#.#.###.#######.#
#.#.#...#.......#.#
#########.###.#####
#.......#...#.....#
#.#.###.###.#######
#.#...#...#.......#
#####.#.#.#.#.#.#.#
#...#.#.#.#.#.#.#.#
#.#.###.#.#.#######
#.#...#.#.#.......#
#.#.#.#.#########.#
#.#.#.#.........#.#
###############.#.#
#.............#.#E#
###################
