###################
#.................#
#.#############.#.#
#.......#...#...#.#
#########.#.#.#.###
#.........#...#.#S#
#.###.#########.#.#
#...#.#.....#...#.#
#.#.###.###.#.###.#
#.#.#...#.#.#.#...#
###.#.###.#.###.###
#...#.#...#.#...#.#
#.###.#.###.#.###.#
#.....#.#...#.....#
#.#####.#.#######.#
#.#.....#.....#...#
#.###.#####.#.#.###
#...#.....#.#.#.#.#
###.###.###.#.#.#.#
#...#...#...#.#...#
#.###.#.#.###.###.#
#.#...#.#...#...#E#
#.###.#.###.#####.#
#.....#...#.......#
###################
