###################
#................S#
#.#.###.###.#.#####
#.#...#...#.#.....#
###.###.#.###.#.###
#.#...#.#...#.#...#
#####.#####.#######
#...#.....#.......#
###.#.#.###.#.#.#.#
#.#.#E#...#.#.#.#.#
#.#.#.#####.#.#####
#.#.#.....#.#.....#
###.###.#######.#.#
#.#...#.......#.#.#
#.#.#.#####.#.#####
#.#.#.....#.#.....#
###.#.#.#########.#
#.#.#.#.........#.#
###.#.###.#########
#.#.#...#.........#
#######.#.###.#####
#.....#.#...#.....#
#.#.#.#.#####.#.###
#.#.#.#.....#.#...#
###################
