###################
#.................#
#.###.#######.###.#
#...#.......#...#.#
#####.#####.###.###
#............S#...#
###.#.#.#.#####.###
#...#.#.#.....#...#
###.#########.#.###
#.#E........#.#...#
#####.#.###.#####.#
#...#.#...#.....#.#
#.#.###.#.#.#.#.###
#.#...#.#.#.#.#...#
#.###############.#
#...............#.#
###.#.#.#.#.#####.#
#.#.#.#.#.#.....#.#
#.#.###.#.#.#######
#.#...#.#.#.......#
#.###.###.#.#####.#
#...#...#.#.....#.#
#.###.###.###.#.#.#
#...#...#...#.#.#.#
###.###.#.#.#.###.#
#.#...#.#.#.#...#.#
###################
