###################
#S#...#...#.......#
#.###.###.###.###.#
#.............#.#.#
#.#####.#####.#.#.#
#.#.#.#...#.....#.#
#.#.#.###########.#
#.#.#...#.#.......#
#.#.###.#.#####.###
#...#.......#.....#
#.###.#####.#.#####
#...#.#.....#...#.#
#######.###.#.#.#.#
#.....#.#.....#...#
#.#####.###.#.#.#.#
#...#.....#.#.#.#.#
#.###.#######.#.###
#...#...#.....#.#.#
#.###.###.#.###.#.#
#.....#...#.#...#.#
#####.#####.#.#.#.#
#.........#.#.#...#
#.###.#.#.###.#####
#...#.#.#.#E......#
#.#########.#.#.###
#.....#.....#.#...#
###################
