###################
#...#.............#
###.#.#######.###.#
#.....#.......#...#
###.#####.###.#####
#...#.......#...#E#
#########.#####.#.#
#...........#.#.#.#
#.#.###.#####.#.#.#
#.#...#...#.#.....#
#.#####.#.#.#######
#.....#.#.#.#.....#
#.#.###.###.#.###.#
#.#...#.........#.#
#######.#.#.#.###.#
#.#.....#.#.#.#...#
#.#.#####.#.#.#####
#.......#.#.#...#S#
###.###.#.#.#####.#
#...#...#.#.......#
###################
