###################
#........S........#
###.#######.#.#.###
#.#.......#.#.#...#
#.#########.###.###
#.........#...#...#
#.#.#.#######.#.###
#.#.#.......#.#...#
#.#####.#.#.#.#.###
#.....#.#.#.#.....#
#########.#####.#.#
#.......#......E#.#
#.###.#####.#.#.###
#...#.....#.#.#...#
#.#####.###.#.#####
#.....#...#.#.....#
#.#####.###.#.#.###
#.....#...#.#.#...#
#####.#############
#...#.............#
###.###.#.#########
#.#...#.#.........#
#.###.#.###.###.#.#
#...#.#...#...#.#.#
#####.#.#.###.#####
#...#.#.#...#.....#
#.#######.#.###.###
#.......#.#...#...#
###################
