###################
#...........#.....#
#.###.#####.#.#.###
#...#.#...#.#.#...#
###.#.#.#.#.#####.#
#...#.#.#.......#.#
#####.#########.#.#
#...#.#...#...#.#.#
#.#.#.#.#.#.#.#.#.#
#.#...#.#.#.#...#.#
#.###.#.#.#.#####.#
#...#.#.#.#...#...#
###.#.#.#.###.#.#.#
#.#.#.#.#.#...#.#.#
#.#.###.#.###.###.#
#.#.....#...#...#.#
#.#########.###.#.#
#...#...#...#.#..E#
#.###.#.#.###.###.#
#.#...#...#...#...#
#.#.#######.#.#.###
#.#.....#...#.#...#
#.#####.#.###.###.#
#.....#S#.#...#...#
#.#.#####.#.###.###
#.#.#.....#.....#.#
#.###.###########.#
#.................#
###################
