###################
#.................#
#.#.#.#######.###.#
#.#.#.......#...#.#
#########.#####.###
#.......#.....#...#
###.#.###.#.#.#.###
#.#.#..S..........#
#######.###.#.#.#.#
#.....#...#.#.#...#
#.#.#####.#.#.###.#
#.#.....#.#.#.....#
###########.#.###.#
#.........#.#...#E#
#############.#.#.#
#...........#.#.#.#
#.#.#.#.#####.#.#.#
#.#.#.#.....#.#.#.#
#.#.#.#####.#.#.###
#.#.#.....#.#.#...#
#.#.#####.#.#.#.#.#
#.#.....#.#.#.#.#.#
###################
