###################
#.....#...#.....#S#
###.###.#.###.###.#
#.......#...#.....#
#.###.###.#.#.#####
#.#.#.#...#...#...#
#.#.#####.#####.#.#
#.......#.#...#.#.#
#####.#.###.#.###.#
#...#.#...#.#.#...#
###.#.#####.#####.#
#.........#....E..#
###.#.###.#.#######
#...#.#...#.#.....#
#.#.#####.#.###.###
#.#.#.#.#...#.....#
#####.#.###.#.###.#
#.......#...#.#.#.#
#.###.###.#.#.#.#.#
#.#.......#...#...#
###################
