###################
#...#.............#
#.###.#.#########.#
#...#E#.......#...#
#.#.#.#######.#.###
#.#...#.......#...#
#.#####.#########.#
#...#...#.......#.#
###.#.#########.#.#
#.#.#.#.......#...#
#.#.#.#.#####.#####
#...#.#...#.#.#...#
#.###.###.#.#.#.#.#
#.#...#.....#...#.#
###.###.#########.#
#...#...#S......#.#
#.#.#.#########.#.#
#.#.#.........#...#
#.#.#########.#####
#.#.#.......#.#...#
#.###.###.###.###.#
#.......#.........#
###################
