###################
#S#...#.......#...#
#.#.#.#####.#.###.#
#.#.#.....#.#.....#
#.#######.#.#####.#
#.#.....#.....#.#.#
#.#.#.###.###.#.###
#.#.#.#...#.......#
#.#.#.#####.#.#.###
#.#.#.#.....#.#...#
#.###.#########.#.#
#.......#.......#.#
#.#####.#.###.#####
#...#.....#...#...#
#.###.#####.###.###
#.#.#.#.#.......#.#
###.#.#.#.#####.#.#
#.....#.#.....#...#
###.###.#####.#.#.#
#...#...#...#.#.#.#
###.#.#.#.###.###.#
#...#.#......E..#.#
#.#.###.#####.#.###
#.#.#.......#.#...#
###################
