###################
#.....#.....#.....#
#.#.###.#.#.#####.#
#.#.....#.#...#...#
#.#######.###.#.#.#
#.#.#.....#.#...#.#
#.#.#.#####.#####.#
#...#.#.........#.#
#.###.#.#######.#.#
#.#...#...#...#.#.#
###.#####.#.#.#.#.#
#...#.....#.#.#.#.#
#.###.#####.#.#.#.#
#.#.#.....#.#...#.#
#.#.#.#####.###.#.#
#S#...#.....#...#.#
#######.#########.#
#.......#.....#...#
#.#####.#.###.#.###
#.#...#.#.#.#...#.#
#.#.#.###.#.#####.#
#...#...#.#E......#
#.#####.#.#.#######
#.....#...#.......#
#####.#########.#.#
#...#.#.......#.#.#
#.#.#.#.#####.###.#
#.#.....#.........#
###################
