###################
#.................#
#######.#####.#####
#.....#.....#.....#
###.#.###.#####.###
#.#.#...#.....#...#
#######.###.###.###
#.....#...#...#...#
#.#.#.###.###.#.#.#
#.#.#...#...#.#.#.#
#.###.###.#.#.#####
#...#E..#.#.#.....#
#.#.###########.###
#.#...........#...#
###.#.###.#######.#
#.#.#...#.......#.#
#######.#.#.#.#.#.#
#.....#.#.#S#.#.#.#
#.###.###.#.###.###
#...#...#.#...#...#
#.#.###########.###
#.#...........#...#
###################
