###################
#.......#.........#
###.#####.#.###.###
#.......#.#.#...#S#
#####.#.#.#.#.###.#
#...#.#...#.#.....#
###.###.#####.#.###
#...........#.#...#
#.#.###.#.#####.###
#.#E..#.#.#.#.#.#.#
#########.#.#.###.#
#.....#.........#.#
#.###.###.#####.#.#
#...#.....#...#.#.#
#####.#######.#.#.#
#.......#.....#...#
#.#####.#####.###.#
#.#...#...#.....#.#
#####.###.#.###.#.#
#.....#.#.#.#.#...#
###.###.###.#.#####
#...#.........#.#.#
#.#.###.#.#####.#.#
#.#.....#...#.#...#
#.#.###.#.###.###.#
#.#.#...#.........#
###.#.#.###.#####.#
#...#.#.#...#.....#
###################
