###################
#.#...#.#.......#.#
#.###.#.#.###.###.#
#...#.......#.#...#
###.#.#####.###.###
#.........#.#...#.#
###.#######.#.###.#
#.......#.........#
#.#######.#.###.###
#...#...#.#...#...#
#.###.#.#.#####.###
#...#.#.......#.#.#
#.###.#####.#.#.#.#
#...#...#.#.#.#E..#
#.###.###.#######.#
#.#S..#.#...#.#...#
#.###.#.###.#.###.#
#.#.#.#.........#.#
#.#.#.#####.###.#.#
#...#.#.....#.....#
###################
