###################
#.................#
#.#########.#####.#
#.#.....#...#...#.#
#.#.#####.###.#.#.#
#E..#.....#...#.#.#
#####.#####.#.###.#
#.....#...#.#.....#
#.#######.#.#######
#.......#.....#...#
#######.#####.#.#.#
#.....#...#...#.#.#
#.###.###.###.###.#
#...#...#..S#.....#
###.###.#########.#
#.#...#...#.......#
#.#.###.#.#.#######
#...#...#.#...#...#
#####.#######.###.#
#.....#.....#...#.#
#.#####.###.###.#.#
#.#...#.#.....#...#
#.#.#.#.#.#######.#
#...#...#.....#...#
#.###########.#.###
#...........#.....#
###################
