###################
#.................#
#.###.#.#.###.###.#
#...#.#.#......E#.#
#.#.#.###.#.#######
#.#.#...#.........#
###.#.#####.#.###.#
#.#.#.......#...#.#
#####.#.###.#.#####
#...#.#.....#.....#
###.#######.#.#.###
#.#.......#.#.#...#
#.#.###.#.#.###.#.#
#.#...#.#.....#.#.#
#.###.#####.#.#.###
#...#......S#.#...#
###.#########.###.#
#.#.........#...#.#
#.#######.#.#######
#.......#.#.......#
#.###.#.#.#######.#
#...#.#.#.......#.#
###.#.#########.###
#.#.#.........#...#
#.#.#####.#.###.#.#
#.#.....#.#...#.#.#
#.#.###########.#.#
#.#...........#.#.#
#.#####.#.#######.#
#.....#.#.......#.#
###################
