###################
#...............#.#
#.###.#########.#.#
#...#.........#.#.#
###.#########.#.#.#
#.#E#...#.....#...#
#.#.#.###.#######.#
#.....#...#.....#.#
#######.###.###.#.#
#.......#...#.#...#
#.#######.###.#####
#.#...#.#.....#...#
#.#.#.#.#####.#.#.#
#.#.#.#.......#.#.#
#.#.#.###.#######.#
#...#...#.#.......#
#######.#.#.###.###
#.......#...#...#S#
#.###########.###.#
#...#...#...#.#...#
#.#.#.#.#.###.#.###
#.#...#.#.#...#...#
#.#####.#.#.#####.#
#.#.#...#.#.#.#...#
#.#.#.###.#.#.#.###
#...#.#.#.....#...#
#####.#.#.#######.#
#.....#.....#.....#
#.###########.#####
#.................#
###################
