###################
#.#...#.....#.....#
#.#.#.###.###.#.###
#...#.#.#...#.#...#
#.#.#.#.###.#.#.###
#.#.#.........#..E#
#.#####.#######.#.#
#.#.#...#.#.#...#.#
#.#.#.###.#.#####.#
#...#.#.#.....#.#.#
###.###.#.###.#.#.#
#.........#.#.#...#
#.###.###.#.#####.#
#.#.#.#.....#.#...#
###.#.#.#.###.#.#.#
#.....#.#.#.....#.#
#.#####.###.#.#.###
#...#.....#.#.#...#
#####.###.#.###.###
#...#.#...#.#.....#
#.#.#.#.#.#####.###
#.#...#.#.#.#.#.#.#
#.#.#####.#.#.#.#.#
#.#.#.......#.#.#.#
#.#####.###.#.###.#
#.#...#.#.......#.#
#.#.###.#.#####.#.#
#.#.....#.....#.#.#
#.###.###.#.#####.#
#S#.....#.#.......#
###################
