###################
#.......#.........#
#.###.###.###.#####
#...#.......#.#...#
###.#########.#.#.#
#.#...#.....#...#.#
#.#.###.###.###.#.#
#.#.#...#.#...#.#.#
#.#.#.###.###.###.#
#...#.#.....#.....#
#####.###.#.#####.#
#...#...#.#.......#
#.#.###.#.#########
#.#...#.#.#.......#
#.###.#.#.#####.###
#.#.....#.....#...#
#.#.#########.###.#
#.#...#...#...#...#
#.#####.#.###.#.#.#
#.....#.#...#...#.#
#.###.#.###.#####.#
#...#E..#.#.#.....#
###.#####.#.#######
#.#.#.....#.......#
#.#.#.###.#######.#
#...#...#.....#S#.#
#.#########.###.#.#
#...#.....#.#...#.#
###.#.###.#.#.###.#
#.....#.....#.....#
###################
