###################
#.................#
#######.#.#.###.#.#
#.....#.#.#...#.#.#
#####.###.#.#.#.###
#...#...#.#.#.#...#
#.#.#.#.#.#####.###
#.#.#.#.#.....#...#
#.#.#.#####.###.#.#
#.#.#.....#...#.#.#
#.###.#####.###.#.#
#..E......#...#.#.#
#.###.#.#########.#
#...#.#.........#.#
###.#.#####.#######
#.#.......#.......#
#####.#.#####.#.#.#
#.....#.....#.#.#.#
#.#.#.#####.###.###
#.#.......#...#...#
###.#.#.#.#.###.###
#.#.#.#.#.#...#...#
###.#.#.#.#######.#
#.#...#.#.......#.#
#####.###.#####.###
#....S..#.....#...#
#.#.#.#.#.#######.#
#.#.#.#.#.......#.#
#.#.#.#######.#.#.#
#.#.#.......#.#.#.#
###################
