###################
#.#...........#S..#
#.#.#####.#.#####.#
#.#.....#.#.#...#.#
#.#####.#.###.#.#.#
#.....#.#.#...#...#
#.#####.#.#.#######
#.#.....#...#.....#
#.#.#########.###.#
#E#.#.........#.#.#
#.#.#########.#.#.#
#.#.........#...#.#
#.#########.###.#.#
#.......#.#.#...#.#
#.#####.#.#.#####.#
#.#.......#.#.....#
#.#######.#.#.###.#
#.....#...#...#.#.#
#.###.#########.#.#
#...#.....#...#...#
#.#######.#.#.#.###
#.#.....#...#.#...#
#.#.###.#####.###.#
#.#.#.#.#...#...#.#
###.#.#.#.#.#.###.#
#...#.#...#.#.#...#
#.###.#####.#.#.###
#.#...........#.#.#
#.#############.#.#
#.................#
###################
