###################
#.................#
###.###.#.#.###.###
#.#...#.#.#...#...#
###.#########.###.#
#.#.........#...#.#
#.#.#.#############
#.#.#.............#
#.#.#.#.#.#.#.#####
#.#.#.#.#.#.#.....#
#.###.#.#.#.###.#.#
#...#.#.#.#E......#
###.###.#.###.###.#
#.#...#.#...#...#.#
#####.#.###.#.#.#.#
#...#.#...#.#.#...#
#.#.#.#.#####.###.#
#.#.#.#.....#.....#
###.#########.#.#.#
#.#.........#.#...#
###.#.#.#####.#.#.#
#.#.#.#.....#.#...#
###.###.#########.#
#.#...#...........#
#####.#######.#.#.#
#...#.......#.#.#.#
###.#######.#.###.#
#.#.......#.#...#.#
#####.#.###.###.#.#
#...#.#...#...#..S#
###################
