###################
#...............#S#
#.###.#####.###.#.#
#.#.#E....#.#.....#
###.#.###.#.#######
#.......#.#...#...#
###.###.#.#####.###
#...#...#.......#.#
#.#########.###.#.#
#.......#...#...#.#
###.###.#########.#
#...#.#.#.......#.#
###.#.###.#####.#.#
#.....#.....#...#.#
###.###.#.#.#.#.#.#
#.....#.#.#.#.#.#.#
#####.#####.#.#.#.#
#.#.....#...#.#...#
#.#.#.#####.#####.#
#...#.....#.#.#...#
###.#######.#.###.#
#.......#.......#.#
#####.#####.#.###.#
#...#.#.#...#.#...#
###.#.#.#.#####.###
#.#...........#.#.#
#.#.#.#.#######.#.#
#...#.#.#.....#...#
#.###.#####.#####.#
#...#.........#...#
###################
