###################
#.#.......#...#..S#
#.#.###.###.###.###
#...#.....#.......#
###.###.###.#.#.###
#...#.......#.#.#.#
#.#####.###.#.###.#
#.#.......#.#.....#
#.#####.###########
#.#...#.#.#.......#
#.###.###.#.###.#.#
#.#...........#.#.#
#.###.#######.###.#
#.......#.....#.#.#
#.#.###.#######.#.#
#.#.#...#.....#...#
###.###.#.#####.###
#...#.#...#.#.#...#
#.###.#.###.#.#.###
#.#.....#.#.#.....#
###.#####.#.#.#.#.#
#.#.#.....#.#.#.#.#
#.#.#.#####.#####.#
#.#...#.........#.#
#.#.#######.#.#.#.#
#.....#.....#.#..E#
#######.#######.#.#
#...#...#.#...#.#.#
#.#####.#.###.###.#
#.......#.........#
###################
