#####################
#........E..#.......#
###.#######.#.#.###.#
#...#.......#.#...#.#
#.###########.###.###
#.........#.....#...#
#####.###.#.#######.#
#S..#...#...#.#...#.#
###.###.#####.#.#.#.#
#.#...#.....#.#.#...#
#.###.#####.#.#.###.#
#.....#.....#.#.#...#
#.#########.#.#.###.#
#.#.......#...#...#.#
#.###.###.#######.#.#
#.....#...........#.#
#####################
