#####################
#...................#
###.#######.#.#######
#.#.......#.#.......#
###.#.#.###.#####.###
#.#S......#.....#...#
#########.#######.###
#...............#...#
###.###.#.#.#####.###
#.#...#.#.#.....#...#
#.#####.#.###.#.#.#.#
#.....#.#...#.#.#.#.#
#########.#####.###.#
#.......#E....#...#.#
#####################
