#####################
#.....#.#E..........#
###.#.#.#.#####.#####
#...#...#...#.......#
#.#.###.#.#########.#
#.#.#...#.#.........#
#.#########.#####.###
#.............#.#...#
#.#####.#.#.#.#.###.#
#..S#...#.#.#.....#.#
#####################
