#####################
#...................#
###.#.#.#########.#.#
#.#.#.#.........#.#.#
#.#.#.#.#.###.#.###.#
#.#.#.#.#...#.#...#.#
#.#####.#.#.#.#.#.###
#E.........S#.#.#...#
###.#####.###.#.#.#.#
#.#.....#...#.#.#.#.#
#####################
