#####################
#...................#
###.#####.###.###.#.#
#.#.....#...#...#.#.#
#.#.#.#.#####.#.###.#
#.#.#.#.....#.#...#.#
#.#.###.#.#.#.###.###
#.#S......#.#...#...#
#####.#.#.#####.#.###
#...#.#.......#.#...#
#########.#####.###.#
#.............#...#.#
#.#.#.###.#.###.#.#.#
#.#.#...#.#...#.#.#.#
###.#####.###.#.#.###
#.#.....#...#.#.#...#
#.#######.#.###.#####
#........E#...#.....#
#####################
