#####################
#...#.......#.......#
#.###.#####.#.#####.#
#.#.......#...#.....#
#.#.###########.#####
#.#.#...........#...#
#.#.#.#############.#
#.#.#.......#...#...#
#.#.#######.#.#.#.###
#.#.#.....#S#.#.#...#
#.#.#####.###.#.###.#
#.#.....#.....#.....#
#.#####.###.#######.#
#...........#....E..#
#####################
