#####################
#S#.......#.........#
#.#.###.#####.#.#.#.#
#...#.....#...#.#.#.#
#########.#.#.#####.#
#.....#.....#.....#.#
#####.#####.#########
#.......#.#..E#.....#
#####.###.#.#.#.###.#
#...#.......#.....#.#
#.#.###############.#
#.#.........#.#.....#
#.#########.#.###.###
#...#.............#.#
#.###.#.#.#.#####.#.#
#.#...#.#.#...#.....#
#####################
