#####################
#...................#
#.#.#.#.#.#########.#
#.#.#.#.#....E....#.#
#####.###.#.#.#.###.#
#...#...#.#.#.#...#.#
#.###.#.#######.###.#
#...#.#.......#...#.#
#.###.#####.#.#######
#...#S....#.#.......#
#.#######.#######.#.#
#.......#.......#.#.#
#####################
