#####################
#.................#.#
#.###.###########.#.#
#...#.#...#...#...#.#
#.#.#.#.#.#.#.###.#.#
#.#.#.#.#...#...#...#
###.#.#.#######.#####
#...#.#.#...#.#.....#
#.#####.#.#.#.#####.#
#.#...#...#.......#.#
#.#.#.###########.#.#
#.#.#.....#.......#.#
#.#.###.#.#.#####.#.#
#.....#.#.#...#S#.#.#
#.#####.###.###.###.#
#E..#...#...#...#...#
###.#.###.###.###.#.#
#...#.......#.....#.#
#####################
