#####################
#...................#
###.###.#.#.#.#.###.#
#.#...#.#.#.#.#...#.#
#.###.#######.#####.#
#...#.......#.....#.#
#.###.#.#.###.#.#.###
#...#E#.#...#.#.#...#
###.#.#####.###.#.###
#.#.#.....#...#S#...#
#######.###########.#
#.....#...........#.#
#####################
