#####################
#.....#...#.........#
###.#.#.#.###.#.#####
#S#.#...#...#.#.#...#
#.#.#######.###.#.#.#
#.#.#.....#...#...#.#
#.#.#####.###.###.#.#
#...#.......#...#.#.#
#####.#####.###.###.#
#.....#...#.#.#.#...#
#.#####.#.#.#.#.#.#.#
#.#...#.#.....#E#.#.#
#.#.#.#.#######.#.#.#
#.#.#.#...#.....#.#.#
#.#.#.#####.#####.#.#
#...#...#...#.....#.#
#.#####.#.#######.#.#
#.....#...........#.#
#####################
