#####################
#...#.#.#.....#.#...#
###.#.#.#####.#.#.#.#
#...........#.....#.#
#.#####.#.###.###.#.#
#...#...#...#...#.#.#
#######.#.#######.###
#S#.....#.#...#.....#
#.#.#######.#####.###
#.......#.#........E#
#######.#.#####.#####
#...................#
#####################
