#####################
#...................#
#.#######.#####.#.#.#
#....E..#.....#.#.#.#
#.#.#.###.#.#####.#.#
#.#.#...#.#....S#.#.#
#.#######.#.#.#.#.###
#.......#.#.#.#.#...#
###.###.#.###.#.###.#
#.#...#.#...#.#...#.#
#.###.#.#######.###.#
#...#.#.......#...#.#
#.#.#.#.#.#########.#
#.#.#.#.#.........#.#
#.###########.#.#.###
#...........#.#.#...#
###.###.#.#####.#####
#.#...#.#.....#.....#
#####################
