#####################
#...#.#.....#.....#.#
###.#.###.###.#####.#
#.........#.#.......#
#.###.#####.###.###.#
#...#.........#.#...#
###.#######.###.#.#.#
#E..#.#.........#.#.#
#.###.#.###.#######.#
#.....#...#S#.......#
#####################
