#####################
#...#...#.#....S#...#
#.#.###.#.#.#####.#.#
#.#.#...#...#.#.#.#.#
###.###.#.###.#.#.###
#.......#.#...#.....#
#.#######.#.#####.###
#.#.......#...#.#.#.#
#.###.###.#.###.#.#.#
#.....#.......#...#.#
#.#####.#####.###.#.#
#.....#.#E......#...#
#.#.#######.###.#.###
#.#.#.#.#.#...#.....#
#.###.#.#.#.#.#####.#
#.......#...#...#.#.#
#####.###.#####.#.#.#
#.....#...#.......#.#
#####################
