#####################
#...#.........#.#...#
#.#.#.#####.#.#.#.#.#
#.#...#...#.#.#.#.#.#
#####.###.#.#.#.#.#.#
#.#.....#...#.....#.#
#.#.#.#########.###.#
#...#.....#.#.#...#.#
#####.#####.#.###.#.#
#..E..#.#.#.....#S#.#
###.#.#.#.#.#.#####.#
#.#.#.#.#...#...#.#.#
#.###.#.#.#######.#.#
#.#.....#...#.....#.#
#.#####.#.#.#.#####.#
#.........#.....#...#
#.#.#####.#.#.###.###
#.#.#.....#.#.#.....#
#####################
