#####################
#..E........#.......#
###.#.#####.#####.###
#...#.#...#.....#...#
#.#####.#.#####.###.#
#.#.....#.#...#.....#
#.#.#####.#.#######.#
#.#.#.....#.......#.#
#.#.#.#########.#.#.#
#.#.#.#.........#.#.#
#.#.#.#####.#######.#
#...#.#S..#.....#...#
#.###.###.#.###.#.###
#...#.....#...#.....#
#####################
