#####################
#.....#.............#
#.#.#.#.#########.#.#
#.#.#.#.#...#...#.#.#
#.#.###.#.###.#.###.#
#.#.......#...#.....#
#.#########.#######.#
#...#S#.....#.....#.#
#####.#.#####.###.#.#
#.....#...#.....#...#
#.#####.#.#####.#####
#.#...#.#...#...#...#
#.#.#.#.###.#.###.###
#...#.#...#.#.#.....#
#####.#####.#.#.###.#
#...#...#...#E#.#...#
#.#####.#.###.###.#.#
#.........#.......#.#
#####################
