#####################
#...#.........#.#...#
#.###.#######.#.#.#.#
#.....#S....#.#...#.#
#.#########.#.#####.#
#.#.......#.#.#...#.#
#.#.#.###.#.#.#.#.#.#
#.#.#.#.#.#...#.#...#
#.###.#.#.#####.###.#
#E....#.........#...#
#####################
