#####################
#S#...#...#.#.......#
#.#.###.###.#.#.#.###
#.......#...#.#.#...#
#.###.#####.#.#######
#.#.#.#.......#...#.#
#.#.#########.#.###.#
#.#.......#.........#
#.#.#.#.#.#.#.#.###.#
#...#.#.#..E#.#.#...#
###.###.###.#####.#.#
#...#.....#.#.....#.#
#####################
