#####################
#.#.....#...#......S#
#.#.###.###.###.#.###
#...#...#.......#.#.#
#####.#.###.#####.#.#
#.....#.#.......#...#
#.#.#######.###.#####
#.#.#.#.#...#.#...#.#
###.#.#.#.###.###.#.#
#......E#.......#...#
#.#####.###.#.#######
#.#.........#.......#
#.###.#.#.#.#.#####.#
#...#.#.#.#.#.#.....#
#####################
