#####################
#.#...........#.....#
#.#.###.#.###.#####.#
#.#.#S#.#...#.......#
#.#.#.#####.#######.#
#.#.#.....#.#.....#.#
#.#.#####.#.###.###.#
#.#.#.....#.#...#...#
#.#.#.#####.#.###.###
#...#....E..#.......#
#####################
