#####################
#........E..........#
#.#.###.#.#.###.#.#.#
#.#...#.#.#...#.#.#.#
#.#####.###.#.#.#.###
#.........#.#.#.#...#
#######.###.###.###.#
#.....#...#...#...#.#
###.#.#.#.#.#.#.#####
#.#.#.#.#.#.#.#.....#
#.#.#.#.#.#.#######.#
#.#.#.#.#.#.......#.#
#######.#.#####.#.#.#
#.......#.....#.#.#.#
#.#.###.###.#.#.#.#.#
#.#....S..#.#.#.#.#.#
#####################
