#####################
#E..................#
#.#.###.###.#####.#.#
#.#...#...#.....#.#.#
#.#.#################
#.#.................#
#.#######.#.#########
#.......#.#.........#
###.###.#######.#.#.#
#.#...#.......#.#.#S#
#####################
