#####################
#..........S........#
#######.#.#.#.#######
#.......#.#.#.......#
#.#.#.#.#####.#####.#
#.#.#.......#.....#.#
#.#####.###.#####.###
#.....#...#.....#...#
#.#.#.#.###.###.#####
#.#.#.....#...#.....#
#####.#.#.#.#####.###
#...#...#.#.....#...#
#.#.#.#.###.#########
#.#.#.#...#.........#
###.###.#######.#.#.#
#.#....E......#.#.#.#
#####################
