#####################
#....E..............#
#########.#######.###
#.......#.......#...#
#.#.###.#.#.#.#.###.#
#.#...#.#.#.#.#...#.#
#.#######.###.#.#####
#........S..#.#.....#
#.#.#####.#.#.#.#####
#.#.....#.#.#.#.....#
#.###.#.###.#####.###
#...#.#...#.....#...#
#######.#.#######.###
#.....#.#.......#...#
#####.#.#.#.#####.###
#...#.#.#.#.....#...#
#####################
