#####################
#.............#.#...#
#####.#####.###.#.###
#.#.......#....E..#.#
#.#####.#.###.#####.#
#.#...#.#.#.#.#.#.#.#
#.#.#.#####.#.#.#.#.#
#...#...#...........#
#.#.#.#.###.###.#.###
#.#.#.#.......#.#...#
#.#######.###.###.#.#
#....S#...#...#...#.#
#####################
