#####################
#.....#.......#..E..#
#.###.#.###.###.#.###
#.#...#.#.#.....#...#
#.#.###.#.###.#####.#
#.#.......#S#.#.....#
#.#########.###.###.#
#.#...#.....#...#...#
#.###.#.#####.#######
#...#.#.....#.......#
###.#.#####.#######.#
#.#...#...#...#.....#
#.###.#.#.###.#.#####
#.#...#.#...#...#...#
#.#.###.###.#####.#.#
#.......#.........#.#
#####################
