#####################
#.#.#.....#.........#
#.#.###.#####.#.###.#
#.......#.....#.#...#
#####.#.#.#########.#
#.....#...#.#...#.#.#
#.#####.###.###.#.#.#
#.....#.....#.......#
#.###.#########.#####
#.#S......#......E..#
#####################
