#####################
#.......#...#.......#
#.#######.#.#.#####.#
#...#.....#...#.....#
#.#.#.#########.###.#
#E#.#.#.....#...#...#
#.#.#.#.#####.#######
#.#.....#S#...#.....#
#.#######.#.###.###.#
#.#...#...#.....#...#
#.#.#.#.#########.#.#
#...#.#...........#.#
#####################
