#####################
#...................#
#.#.###.###.#.#.#####
#.#...#...#.#.#.....#
#############.#.#####
#....E......#.#.....#
#.#.###.#########.###
#.#...#.........#...#
#.#.#.#####.#######.#
#.#.#.....#.......#.#
#####.#.#.###.#.#.###
#...#.#.#S..#.#.#...#
###.#####.#####.#####
#.#.....#.....#.....#
#####################
