#####################
#.#...........#...#.#
#.#.###.#######.#.#.#
#.#...#.....#...#S#.#
#.###.#####.#.#####.#
#..E#...#.#...#.....#
#.#####.#.#####.#.###
#.....#...#.....#...#
#####.###.#########.#
#.......#.#.........#
#.#######.#.#######.#
#...........#.......#
#####################
