#####################
#...................#
#.###.###.#.#.#.#####
#...#...#.#.#.#.....#
#####.###.#.#.#.#.###
#..S......#.#.#.#...#
#.#####.#.###.#.###.#
#.....#.#...#.#...#.#
###.#####.#####.#####
#.#.....#E....#.....#
#####################
