#####################
#...................#
#.#######.#.#####.#.#
#.......#.#.....#.#.#
###.#########.#####.#
#.#.........#.....#.#
#.#####.#.#.###.#####
#.....#.#.#...#.....#
###.###.###.#####.###
#.#........E....#...#
###.#####.#.###.###.#
#.......#.#...#...#.#
#.#.#.#.#.###.#####.#
#...#.#.#...#.....#.#
###.#############.###
#.#S............#...#
###.#####.#.#########
#.#.....#.#.........#
#####################
