#####################
#...#.#.......#.#...#
#.#.#.#.#####.#.#.#.#
#.#...#..S#.#.#.#.#.#
#.#########.#.#.#.#.#
#.#.........#.#...#.#
#.#.#####.#.#.#.###.#
#...#.....#.#.#...#.#
#.###.###.###.#####.#
#...#E..#.#...#...#.#
###.###.###.###.#.#.#
#.....#.........#...#
#####################
