#####################
#S#.#.#...#.......#.#
#.#.#.###.#.#.#.###.#
#.#...#.....#.#.....#
#.###.#.###.#######.#
#...#.#...#.#...#...#
#.###.#.#.#####.#.###
#.#...#.#...#.......#
#.###.#.#####.###.#.#
#.......#.#.#.#...#.#
#.#.#####.#.#######.#
#.#...#.....#.#.#.#.#
#.#.#.#.###.#.#.#.#.#
#.#.#.#E..#...#.....#
#.###.#.#.#####.#.#.#
#.#.....#...#...#.#.#
#####################
