#####################
#...................#
#.#########.#.###.#.#
#..........E#...#.#.#
#.#.###.#####.#.###.#
#.#.........#.#...#.#
#######.#.###.#.#####
#.......#...#.#.....#
#.#.###.#.#.#.#.#.###
#.#....S#.#.#.#.#...#
#.#####.#.###.#######
#.....#.#...#.......#
#.#.#####.###.#.###.#
#.#.....#...#.#...#.#
#####################
