#####################
#.#.#...#...........#
#.#.###.#.#.###.#####
#.#.....#.#...#.....#
#.#.#.#.#.###.###.#.#
#.#.#.#.#...#...#.#.#
#.#.#######.#######.#
#.#.....#...#E....#.#
#.#.#.###.###.#######
#...#...#.....#.....#
###.#####.#.#.#.#####
#.#.......#.#.......#
#.#.#######.#####.###
#...#.........#....S#
#####################
