#####################
#.....#.......#.....#
#.#.###.###.###.###.#
#.#.....#S#.......#.#
#########.#.#######.#
#.........#...#.#...#
#.###########.#.#.###
#.#.......#...#.#...#
#.#.#.###.#.###.###.#
#.#.#.#...#.....#.#.#
#.###.#.#######.#.#.#
#...#.#...#.......#.#
###.#.###.#########.#
#...#.#E..#...#.....#
#.###.#.###.#.#.###.#
#.....#.....#...#...#
#####################
