#####################
#...#.#.#.#..E#.....#
###.#.#.#.#.#.#.#.###
#.....#.#.#.#...#...#
#.#.###.#.#.#######.#
#.#.#...#.....#.#...#
###.###.#######.#.###
#.......#.......#..S#
#.#.#.#####.#####.###
#.#.#.#.........#...#
#.#####.###.###.#.###
#.#.....#...#.......#
#.###.###.#######.#.#
#.....#...#.......#.#
#####################
