#####################
#.......#.....#.....#
#.#.#####.#.#.#####.#
#.#.......#.#.......#
#.#########.#######.#
#.#E....#.#.....#.#.#
#.#.###.#.#####.#.#.#
#.#.#...#.#S..#.#...#
#.#.#.###.###.#.#.###
#...#.......#...#...#
#####################
