#####################
#...................#
#####.#.#####.#.#.#.#
#...#.#.....#.#.#.#.#
###.###########.#.###
#.#...........#.#...#
#####.#####.#######.#
#...#..E..#.......#.#
###.#.#######.#.###.#
#.#.#.......#.#..S#.#
#.###.#.#.###.#.#####
#...#.#.#...#.#.....#
#####################
