#####################
#.......#...........#
#.#.#####.#####.###.#
#.#...........#.#.#.#
#.#############.#.#.#
#.......#.......#...#
#########.#########.#
#.........#.......#.#
#.#######.#.#####.#.#
#.#..E....#.#.#...#.#
#.#######.#.#.#.#####
#.#.....#.#...#....S#
#.#.###.#####.#######
#.....#.............#
#####################
