#####################
#...................#
#####.#####.#.#.#.#.#
#...#.....#.#.#.#.#.#
#######.#####.#.#.###
#.....#.....#.#.#...#
###################.#
#.................#.#
###.###.#####.#.###.#
#.#...#.....#.#...#.#
#######.#####.#.#####
#.....#.....#.#.....#
#.#.#.#.#####.#####.#
#.#S...........E..#.#
#####.###########.#.#
#...#...........#.#.#
###.#################
#.#.................#
###########.###.###.#
#.........#...#...#.#
#.###.#######.#.#.###
#...#.......#.#.#...#
#####################
