#####################
#...#...........#...#
#.#.#.###.#####.#.#.#
#.#.....#.#.#...#.#.#
#.#######.#.#.###.#.#
#.....#...#...#...#.#
#######.###.###.#.#.#
#.......#...#...#.#.#
#.#######.###.###.#.#
#.....#.....#...#.#.#
#.###.#####.#####.###
#...#.....#E....#...#
#.#####.#.#####.###.#
#.#...#.#.#...#.....#
###.#.###.#.#.#####.#
#...#.....#.#...#...#
#.#########.###.#.###
#.....#.#...#.#...#.#
#####.#.#.###.#####.#
#.....#.#.......#...#
#.#####.#######.#.#.#
#..S#.............#.#
#####################
