#####################
#.....#.......#.....#
###.###.###.#.#.###.#
#.........#.#...#.#.#
###.###.#####.#.#.###
#.....#.#...#.#.....#
###.#####.#######.###
#.............#.#...#
#####.#.#####.#.###.#
#.#.#.#...#.#...#...#
#.#.#.#.###.#########
#.....#.#...#.......#
#######.#.#####.#####
#.......#...........#
#######.#.#####.#####
#.#...#.....#......S#
#.#.#########.#######
#......E......#.....#
###.###.#.#.#.#.###.#
#.....#.#.#.#.....#.#
#####################
