#####################
#...................#
###.#.#.#####.#.#.#.#
#.#.#.#.....#.#.#.#.#
#.#####.#.#.#######.#
#.....#.#.#.......#.#
#.#######.###.#.#.#.#
#.......#...#.#.#.#.#
#########.#.#.#####.#
#.......#.#.#.....#.#
#.#####.#########.###
#.....#.........#...#
#.#.#.#####.###.#####
#.#.#.....#...#.....#
#.#.#.###.#########.#
#..............S..#.#
#.#####.###.#.###.#.#
#.....#...#.#...#.#.#
#.###.###.#.#.###.#.#
#E..#...#.#.#...#.#.#
#####################
