#####################
#......E............#
#.###.#.#.###.#.#.#.#
#...#.#.#...#.#.#.#.#
###.###.#.###.#####.#
#.#...#.#...#.....#S#
#####.#########.#.###
#...#.........#.#...#
#.###.#.#.###.#.#####
#...#.#.#...#.#.....#
#.#.#####.#.###.#.#.#
#.#.....#.#...#.#.#.#
###.#######.#.#####.#
#.#.......#.#.....#.#
#.#.###.#######.#.#.#
#.#...#.......#.#.#.#
###.#.#####.#####.#.#
#.#.#.....#.....#.#.#
#######.###.#.#.###.#
#.....#...#.#.#...#.#
#####.#.#######.#.#.#
#...#.#.......#.#.#.#
#####.#.#####.#.#####
#...#.#.....#.#.....#
###.###.#.#.#.#####.#
#.#...#.#.#.#.....#.#
#.#.#.###.#.#########
#.#.#...#.#.........#
#####################
