#####################
#...................#
#.###.#.#####.###.#.#
#...#.#.....#...#.#.#
###.###.#######.#####
#.#...#.......#.....#
###########.#########
#.........#.........#
###.###.#######.#####
#.#...#.......#.....#
###.#.#.###.#.#####.#
#.#.#.#...#.#.....#.#
#######.###.#.#######
#............E......#
#####.#.#.#.###.###.#
#.....#.#.#...#...#.#
###.#.###.#######.#.#
#.#.....#.......#.#.#
###.#.#########.#.#.#
#.#...........#.#.#.#
#.###.###.#.#.#.###.#
#.......#.#.#.#...#.#
###.#.###########.###
#.#..S..........#...#
#####################
