#####################
#.#....S#.........#.#
#.#.#####.###.#.###.#
#...#...#.#...#.#...#
#.###.#.#.#.#####.###
#...#.#...#.....#...#
###.###.#####.#.#.#.#
#E#...#...#...#.#.#.#
#.#.#.#####.###.#.#.#
#...#.....#.#.#...#.#
###.#####.#.#.#######
#...#...........#...#
#####.#######.#.#.###
#...........#.#.....#
#.###.#####.#######.#
#...#.#.#.......#...#
#######.#.#.#####.###
#.#.#.....#.#.......#
#.#.#.###.#.###.###.#
#.......#.#...#...#.#
#####################
