#####################
#.......#.#.#.......#
#.#.#.###.#.###.###.#
#.#.#.....#.....#...#
#########.#.#####.#.#
#.........#.....#.#.#
###.###.#####.###.#.#
#.#.#.#.....#...#S#.#
#.#.#.#######.#######
#...#.#...#...#...#.#
#.#.#.###.#.###.###.#
#.#.........#...#.#.#
#.#########.#.#.#.#.#
#.......#.....#.#...#
#.#.###.#####.#####.#
#.#.#...#.#...#...#.#
#.#.###.#.#####.###.#
#.#...#.........#.#.#
#.#######.#.###.#.#.#
#.#.......#.#.#.....#
###.#######.#.#####.#
#.#......E#.......#.#
#.#####.#########.#.#
#.......#.........#.#
#####################
