#####################
#.........#...#S#...#
#.#####.###.#.#.###.#
#.....#.#...#.#.....#
#.###.###.###.#####.#
#...#...#...#.....#.#
#.#####.###.#####.#.#
#.#..E#.....#.....#.#
###.#.#######.#.###.#
#...#.......#.#.#...#
#.###.#####.#.#.#.###
#.#...#...#...#.#...#
#.#####.#.#.#######.#
#.......#.#.#.....#.#
#######.#.#.#.#.###.#
#.....#.#.#.#.#...#.#
#.###.###.###.###.#.#
#...#.....#...#...#.#
#.#.#####.#.###.###.#
#.#.#...#.#.#.#.....#
#.#.#.#.###.#.#######
#.#.#.#.....#...#...#
#.#.#.#######.#.#.#.#
#.#...........#...#.#
#####################
