#####################
#.....#.........#...#
#.###.#.#######.#.#.#
#.#...#.#.....#...#.#
#.###.#.###.#####.#.#
#...#.#.#E..#...#.#.#
###.###.#.#.#.#.###.#
#...#...#.#.#.#.....#
#.###.###.###.#######
#.....#.....#...#...#
#.#####.###.###.###.#
#.#.#...#.#...#S#...#
#.#.#.###.#.#.###.#.#
#.#.#.#...#.#.#...#.#
#.#.#.###.#.###.#.###
#.#.......#.....#...#
#.#################.#
#.......#.....#.....#
#######.#.###.#.###.#
#.......#...#.#.#.#.#
#.#########.#.#.#.#.#
#...........#...#...#
#####################
