#####################
#.........#.........#
#.#.###.#.#.###.#.###
#.#.#...#.#...#.#.#.#
#.###.###.#####.###.#
#...#...#.#.........#
#.###.###.###.###.###
#.#...#.........#...#
#.#######.#.###.###.#
#...#...#.#.#...#...#
###.#.###.#########.#
#.#.#.#.....#.....#.#
#.###.#.###.#####.#.#
#...#...#...#.#E#.#.#
#.###.#######.#.#.#.#
#.....#.#...#...#.#.#
#.#.#.#.#.#.###.#.#.#
#.#.#...#.#.#.....#.#
###.#.#####.#.#####.#
#...#.......#.#.#...#
#.###.#.#.#.#.#.#.#.#
#..S#.#.#.#.....#.#.#
#####################
