#####################
#...#.#.............#
#.#.#.#.###########.#
#.#...#.......#.....#
#.#####.#######.###.#
#.#.....#.....#...#.#
#.#.#####.###.#.#.###
#...#...#...#.#.#...#
#.###.#.###.#.#####.#
#E#.#.#...#.#.#.....#
#.#.#.###.#.#.#.#####
#.#.#...#...#...#S..#
#.#.###.#####.#####.#
#...#...#...#.#...#.#
#.###.###.###.#.#.#.#
#.#...#.......#.#.#.#
###.###.#######.#.#.#
#...#.....#.#...#...#
#.#######.#.#.#######
#.#...#...#.#.#.....#
#.#.#.###.#.#.#.#.###
#.#.#...#...#.#.#...#
#.#.###.###.#.#.###.#
#...#.#...#.#.#...#.#
#.###.###.###.#####.#
#.....#...#...#.....#
#####.#.###.###.###.#
#.....#.........#...#
#####################
