#####################
#.......#.....#.....#
#.#.###.#.###.#.#.###
#.#.#...#.#.#.#.#...#
#.#.#.###.#.#.#.###.#
#.#.#.#...#...#...#.#
###.#.#.###.###.###.#
#...#...#...#...#...#
#.#.#####.#######.###
#.#.#S#.#.#.....#...#
#.#.#.#.#.###.#.###.#
#.#.#.#.#.....#.#...#
#.###.#.#######.#.#.#
#.....#.....#.#.#.#.#
#######.#.#.#.#.#.###
#...#...#.#...#.#...#
#.###.###.###.#.###.#
#.#...#.#...#.#.....#
#.#.###.###.#######.#
#E........#.........#
#####################
