#####################
#.......#...........#
#.#####.#.#.#######.#
#.#...#...#.#.......#
#.#.#.#####.#.#####.#
#.#.#.#.....#.#...#.#
#.###.#.#####.#.#.###
#.....#.#.....#.#...#
#.#####.#####.#.###.#
#.#.....#...#.#.#...#
###.#.###.#.###.#.###
#...#.#...#.#...#.#.#
#.#####.###.#.###.#.#
#.#.....#...#.#...#.#
#.#.#####.###.#.###.#
#...#...#.#S..#.#...#
#.###.###.#####.#.###
#...#.#.....#...#...#
###.#.#.#####.#####.#
#.....#............E#
#####################
