#####################
#...................#
#.#.#.#####.###.#####
#.#.#.....#...#E....#
###.#.###.#.#.###.#.#
#.#.#...#.#.#...#.#.#
#.#.#####.###.#.#.#.#
#.#.....#...#.#.#.#.#
#.#.#.#.#########.#.#
#.#.#.#.........#.#.#
###.#.#.#.#.#####.###
#.#.#.#.#.#.....#...#
#######.#.###.#######
#.....#.#...#.......#
###.#.#.###########.#
#.#.#.#...........#.#
###.#########.###.###
#.#.........#...#..S#
#.#########.###.#.#.#
#.........#...#.#.#.#
#####################
