#####################
#...#.......#S..#.#.#
#.###.###.#####.#.#.#
#.#.....#.#...#...#.#
#.#######.###.#.#.#.#
#...#...........#...#
#.#.###.###.#####.###
#.#.....#...#.....#.#
#.###.#####.###.###.#
#...#.#...#.#...#.#.#
###.###.#.#######.#.#
#.#.....#.#...#.....#
#.#######.#.###.###.#
#.#.#.....#.#...#...#
#.#.#.#####.###.###.#
#.....#.#.#...#.#.#.#
#.#.#.#.#.#.#.#.#.###
#.#.#.....#.#.......#
#######.#.###.###.#.#
#.#.#...#.......#.#.#
#.#.#######.#.###.#.#
#E..........#...#.#.#
###.#####.###########
#.....#.#...........#
###.###.#######.###.#
#...........#.....#.#
#####################
