#####################
#...........#.......#
#.#########.#.#.###.#
#.....#...#...#...#.#
###.###.#.#######.#.#
#...#...#...#.....#.#
#.###.#####.#.#####.#
#...#.....#E#.#...#.#
#########.#.#.#.#.#.#
#.....#...#...#.#.#.#
#.###.#.#######.#.#.#
#.#S..#.....#...#.#.#
#.#####.###.#.#.###.#
#.#.....#...#.#.....#
#.###.###.###.#######
#...#...#...#...#...#
###.#######.###.#.###
#.#...#.....#.#.#...#
#.###.#.#####.#.###.#
#.......#...........#
#####################
