#####################
#...................#
#.#######.#.#.###.#.#
#.......#.#.#...#.#.#
###########.###.###.#
#..................E#
###.#.#.#########.###
#.#.#...........#...#
#.#.###.#####.###.#.#
#.#.........#...#.#.#
###.#.#.#####.###.###
#.#.#.......#...#...#
#######.###.#####.#.#
#.........#.....#.#.#
#.###.#.#.#######.###
#...#.#S#.......#...#
#########.#.#.#####.#
#.......#.#.#.....#.#
#####.###.#.#####.#.#
#...#...#.#.....#.#.#
###.#.#.#.#.###.###.#
#.#.#.#.#.#...#...#.#
###.###########.#.###
#.#...........#.#...#
#####################
