#####################
#...................#
#.#.#.#####.###.#.###
#.#.#.....#...#.#...#
#.###.#.#####.#######
#...#.#.....#.......#
#.#.#.#.#####.#######
#.#.#.#..........E..#
#.#.###.#.#.#.#####.#
#.#.....#.#.#.....#.#
#######.#.#.###.#####
#......S#.#...#.....#
###.#.###############
#.#.#...............#
#.#.#####.#########.#
#.#.....#.........#.#
#.###.#.#####.#.###.#
#...#.#.....#.#...#.#
#.#.###.###.#.#.#####
#.#...#...#.#.#.....#
#.#.#####.#.#####.###
#.#.....#.#.....#...#
###.###.###.#######.#
#.#...#...#.......#.#
#####################
