#####################
#...............#...#
#.###.#########.###.#
#.#...#.......#.....#
#.#.###.#####.#######
#.#.#...#.....#.....#
#.###.###.#####.###.#
#.#...#...#...#...#.#
#.#.###.###.#.#.###.#
#.#...#.#...#...#...#
#.###.#.#.#######.#.#
#.....#...#.......#.#
#.#########.#.#####.#
#.#.#.......#.#...#.#
#.#.#.###.#####.#.###
#...#...#.#.....#...#
###.###.#.#.#######.#
#...#...#.#.#...#...#
#.###.###.#.#.#.#.###
#...#.#...#.#.#.#...#
###.#.#####.#.#.###.#
#...#.#.....#S#...#.#
#.###.#.#########.#.#
#.#...#.........#.#.#
###.#.#######.###.#.#
#...#...#.....#...#.#
#.#######.#####.###.#
#....E........#.....#
#####################
