#####################
#..E................#
#####.###.#.#######.#
#...#...#.#.......#.#
###.#.#.#######.#####
#.#.#.#.......#.....#
###.#.#.#.#########.#
#.#.#.#.#..S......#.#
#.#.###.#####.#.#.###
#.#...#.....#.#.#...#
#.###.#####.#.###.###
#...#.....#.#...#...#
#######.###.###.#####
#.....#...#...#.....#
###.#####.#.#######.#
#.#.....#.#.......#.#
#.#####.###.#.#.#.###
#.....#...#.#.#.#...#
#.###.#.#.###.#.###.#
#...#.#.#...#.#...#.#
###.###.#.###########
#.#...#.#...........#
#.###.#.#####.#.#.#.#
#...#.#.....#.#.#.#.#
#.###.###.#.#####.###
#...#...#.#.....#...#
#####################
