#####################
#.....#.........#...#
###.###.#######.#.#.#
#...#...#.......#.#.#
#.###.###.#######.#.#
#.....#...#...#...#.#
#.#####.###.#.#.###.#
#.#.#S..#...#...#...#
#.#.#####.#.#####.###
#...#.....#.#.......#
###.###.###.#######.#
#.#...#...#.....#.#.#
#.###.#####.###.#.#.#
#.....#...#.#.#.#.#.#
#.#####.#.#.#.#.#.#.#
#.#.....#.#...#.#.#.#
#.#####.#.#####.#.#.#
#.#.....#.....#.#...#
#.#.#########.#.#####
#...#.........#.....#
#####.#########.###.#
#...#.#E....#...#...#
#.###.###.#.#####.#.#
#.........#.......#.#
#####################
