#####################
#.#.#...#..S#.......#
#.#.#.###.#####.###.#
#.#.....#.......#...#
#.#.#####.#########.#
#.#...#.#.......#.#.#
#.#.###.#######.#.###
#.....#.....#.......#
#.#.#####.#.###.#.###
#.#.....#.#.#...#...#
#####.#.#.#.#.#.###.#
#...#.#.#.#...#.#...#
#.###.#.###.#.#.#####
#.....#...#.#.#.#...#
#######.###.###.#.#.#
#...#.....#...#.#.#.#
#.#.#.###.###.#####.#
#.#.#.#.....#...#...#
#.#####.#####.#####.#
#.#.....#...#.......#
#.#.#####.#.###.#.###
#.........#.#E#.#...#
#####.#####.#.#.#.#.#
#.........#.....#.#.#
#####################
