#####################
#.....#.......#...#.#
###.#.#.#####.#.#.#.#
#...#.#.#.......#...#
###.#.#.###########.#
#...#.....#.........#
###.###.#.#.#####.###
#.#.#...#.#.#.......#
#.#########.###.#####
#.....#.....#.#.#E..#
###.#####.###.#####.#
#.........#.....#...#
###.###.#.###.#.###.#
#...#...#.#...#.....#
#####.###.#####.#####
#.#.#.#.......#.....#
#.#.#.#####.#####.#.#
#.#...#.#...#.....#.#
#.###.#.#.#.#.#####.#
#.......#.#.....#.#.#
###.###.#########.#.#
#.....#.#.........#.#
#.#######.###.#####.#
#...........#....S#.#
#####################
