#####################
#.........#...#.#..E#
#.#######.#.###.#.#.#
#.......#.#.#.....#.#
#.###.#.###.###.#.###
#.#...#.#...#...#...#
#.#####.#.#########.#
#.#...#.#.#.....#...#
#####.#.#.#.###.###.#
#.......#...#.......#
#####.#.###.#####.#.#
#...#.#.#.......#.#.#
###.###.#.#.#####.###
#S........#...#.....#
###.#######.###.#####
#.#.#...#.....#.....#
#.#.#.#######.#.#.#.#
#...#.#.....#.#.#.#.#
#.###.#.###.###.###.#
#.....#...#.......#.#
#####################
