#####################
#..E....#.......#...#
#.#.###.#.###.#.#.#.#
#.#...#.#...#.#...#.#
#.###.#####.#.#####.#
#.#.#.......#...#...#
#.#.###########.#.###
#.#.....#...#...#...#
#.###.###.#.#.#####.#
#.....#...#.#...#...#
#####.#.###.###.#####
#.....#...#...#.....#
#.#######.###.#####.#
#.......#.#.#.....#.#
#########.#.#####.#.#
#.........#.....#.#.#
#.#########.#####.#.#
#.......#.......#...#
#.#####.#.#####.###.#
#.#.....#.#...#...#.#
###.#####.#.#.###.#.#
#S..#.....#.#.#.#.#.#
#####.#####.#.#.#.#.#
#.....#.....#...#...#
#.#########.###.#####
#...........#.......#
#####################
