#####################
#...................#
#.#.#.#.#######.###.#
#.#.#.#.......#...#.#
#####.#######.###.#.#
#...#.......#...#.#.#
#####.#######.#.#.#.#
#...#.......#.#.#.#.#
#.#.#####.#######.###
#.#.....#.......#...#
###.#.###.#.###.#.#.#
#.#.#...#.#...#.#.#.#
###########.#.#####.#
#.........#.#.....#.#
#.#.#.#.#############
#.#.#.#.............#
#.#.###.#.#####.#.###
#.#...#.#.....#.#...#
###.#.#########.#.#.#
#.#.#E........#.#.#.#
#####.#.#.#.#####.###
#...#.#.#.#.....#...#
#.#########.#.#.###.#
#.........#.#.#...#.#
#########.#.#.#.#.#.#
#.......#.#.#S#.#.#.#
###.###.#######.#.#.#
#.#...#.......#.#.#.#
#####################
