#####################
#.#S#...........#...#
#.#.#.#########.#.#.#
#.#.#.......#...#.#.#
#.#.#.#####.#.###.###
#.#.#.....#.#.#.....#
#.#.###.###.#.#.###.#
#.#.#.#.#...#.#...#.#
#.#.#.#.#.###.#####.#
#...#...#.#.#.#E....#
#.#####.#.#.#.#.###.#
#.....#.#.#.#...#.#.#
#####.###.#.#####.#.#
#...#.....#...#.....#
#.#.#######.###.#####
#.#...#.......#.#...#
#.#####.#####.#.###.#
#.....#...#...#.#...#
#.###.###.#.#.#.#.#.#
#.#.#...#.#.#.#.#.#.#
#.#.###.#.#.#.#.#.#.#
#...#.#.#.#.#.#...#.#
###.#.#.#.#.#######.#
#.#...#.#.#.......#.#
#.###.#.#.###.#####.#
#.....#.....#.......#
#####################
