#####################
#...#.........#.....#
###.#.###.#####.#.###
#...#...#.#.....#.#S#
#.#####.#.#.#####.#.#
#.......#...#...#.#.#
#.###########.#.#.#.#
#.......#.#...#...#.#
#######.#.#.#######.#
#.........#.#.......#
#.#########.#.#######
#...#.......#.#.#...#
###.#.#####.#.#.#.#.#
#.#.#.#..E..#.#.#.#.#
#.#.#.###.###.#.#.#.#
#.#.#...#...#.#...#.#
#.#.###.###.#.###.#.#
#.....#.#...#...#.#.#
#.#####.#.#####.#.#.#
#.#...#.#.#...#.#.#.#
#.#.#.#.#.###.#.###.#
#.#.#...#...#.#.....#
#.#.#######.#.#####.#
#.#...#...#.....#...#
#.###.#.#.#####.#.###
#.#.#...#.#.....#.#.#
#.#.#####.#######.#.#
#.......#...........#
#####################
