#####################
#...................#
###.#.###.###.#####.#
#.#.#...#...#.....#.#
#.#####.###.#########
#.....#...#.........#
###.#.#.#####.#.#.###
#.#.#.#.....#.#.#...#
#######.#.###.#.#.#.#
#.....#.#...#.#.#.#.#
###.#.#.#########.###
#.#.#.#.........#...#
###########.#.#.#####
#.........#.#.#.....#
#.#.###.#.#.###.#.#.#
#.#...#.#.#...#.#.#.#
###.#####.#####.###.#
#.#.....#.....#...#.#
#####.#########.#####
#...#..............E#
#####.#.#.###.#######
#...#.#.....#.......#
#.###.#.#.#.#########
#...#.#...#.........#
#.#######.#.#.#.#.###
#........S#.#.#.#...#
#####################
