#####################
#.......#.....#E....#
#####.#.###.#.#.###.#
#.....#...#.#...#.#.#
#.#######.#.#####.#.#
#.....#.....#...#...#
#####.#########.#.###
#...#...#.......#...#
#.#.###.#.#####.###.#
#.#.....#.#.......#.#
#.#######.#######.#.#
#.....#...#...#...#.#
#####.#.#.#.#.#####.#
#.....#.#...#.....#.#
#.#########.#####.#.#
#.....#S..#.#.....#.#
#.###.###.#.#.#.###.#
#...#...#.#.#.#.#...#
###.#.###.#.#.#.#.###
#...#...#.#.#.#.#.#.#
#######.#.###.###.#.#
#.......#...#.....#.#
#.#########.#.#####.#
#...........#.......#
#####################
