#####################
#.#.#.........#...#.#
#.#.#.#######.#.###.#
#.#.#.#.#.#.#....E#.#
#.#.###.#.#.###.#.#.#
#...#S..#...#...#...#
#.#####.#.#.#####.#.#
#...#...#.#.....#.#.#
#.#####.#.#######.#.#
#...#.............#.#
#.###.#.#.###.#.#####
#.#...#.#...#.#.....#
#.###.#######.#.###.#
#.....#.......#.#...#
###.#.#.#########.###
#...#.#.#...#...#.#.#
#.#######.#.#.###.#.#
#.#.......#.#.#.....#
###.#######.#.#.#####
#...#...............#
#.###.###.#####.###.#
#.#.....#...#.....#.#
#####################
