#####################
#....S..............#
#.###.#####.#.#.#####
#...#.....#.#.#.....#
###.#.#####.#####.###
#.#.......#.....#...#
###.#.#.#.#.###.#####
#.#.#.#.#.#...#.....#
###.#.#.#.#########.#
#.#...#.#.........#.#
#####.#####.#.###.###
#...#.....#.#...#...#
#####.###.###.###.#.#
#...#...#...#...#.#.#
#####.#.#.###.#######
#....E#.#...#.......#
#.#.###.#.###.#.#.#.#
#.#...#.#...#.#.#.#.#
#####.#.#.#.#.#.###.#
#...#.#.#.#.#.#...#.#
###########.#.#####.#
#.........#.#.....#.#
#####################
