#####################
#.#.....#.....#.#...#
#.#.###.###.#.#.#.#.#
#.....#.....#.#...#.#
#.#.#######.#.#####.#
#.#.#.#.....#...#...#
###.#.###.#.#######.#
#...#.....#.#.#.#.#.#
#.###.#####.#.#.#.#.#
#...#.#.#...#.......#
#.#.###.###.#######.#
#.#.......#.....#...#
#.###.#.#######.#.#.#
#...#.#...#.#...#.#.#
#.#######.#.#.#.###.#
#.#...#.#.#...#.....#
#####.#.#.#####.#.###
#.#.....#.#...#.#...#
#.#.#####.#.#######.#
#.#.......#...#S#.#.#
#.#.#####.#.#.#.#.###
#.#...#...#.#.#.....#
#.#####.#####.#.#####
#.........#...#.#...#
#.#.#########.#.#.###
#.#...#...#.........#
###.#.###.#.#.###.###
#...#E......#.#.....#
#####################
