#####################
#...#.#.#...#.......#
###.#.#.###.#####.#.#
#.....#.#.........#.#
###.###.###########.#
#...#...#...#...#...#
###.#.###.#.###.###.#
#...#...#.#.#.......#
#.###.###.#.#######.#
#.#.....#.#.........#
#.###.###.#.#.###.#.#
#...#.....#.#...#.#.#
#.#.###########.###.#
#.#.#...#.#...#...#S#
#.#.###.#.#.#####.###
#.#.......#.....#...#
#.#####.#.#.#######.#
#.#...#.#E..#...#...#
###.#.#####.###.#.#.#
#.#.#.......#.#...#.#
#.#.#.#####.#.#.###.#
#...#.#.........#...#
#####################
