#####################
#.........#.....#.#.#
#.###.#.###.###.#.#.#
#.#...#E....#.......#
###.###.###.###.###.#
#...#.#...#...#.#...#
#.###.#.#####.#######
#.#...#.#.#.......#.#
###.#.###.#####.###.#
#.#.#...#...........#
#.#.#.###.#.#####.###
#...#.#...#.....#...#
#####.#.#######.#####
#.....#.#...........#
#.#######.#.###.###.#
#....S#...#.#...#.#.#
#.#######.#####.#.#.#
#...#...#.#...#...#.#
#.###.#####.#.#.#####
#...#.#.....#.....#.#
#.#.#.#.###.#.#.###.#
#.#.....#...#.#.#.#.#
#.#########.#.#.#.#.#
#.....#.....#.#.....#
#.#.###.#######.###.#
#.#...#.....#.....#.#
#####################
