#####################
#...#...#...#.....#.#
###.#.#####.###.###.#
#.#.#...#...........#
#.#.#.#####.#.#.#.#.#
#.......#...#.#.#.#.#
###.#####.###.#####.#
#.....#...#.#...#.#.#
#.#########.#.#.#.#.#
#.#.....#...#.#.#...#
#.#.#######.###.#.###
#...#...#S......#.#.#
#.###.#######.#.#.#.#
#.#...........#.#...#
#.#####.#########.#.#
#.....#.....#...#.#.#
#####.###.#####.###.#
#...#...#.#...#.#...#
#.#.#.###.#.#.#.#.###
#.#.......#.#.....#.#
#.#########.#.#####.#
#...#...#...#.#.....#
###.#.#.#.#.###.#####
#.#.#.#...#...#.....#
#.#.#######.#######.#
#..E#.#...#...#.#.#.#
#####.###.#.#.#.#.#.#
#...........#.......#
#####################
