#####################
#...................#
#.###.###.#.#.#.#.###
#...#...#.#.#.#.#...#
###.#.#.#.#.#######.#
#.#.#.#..........E#.#
#.#####.#.#.#.###.#.#
#.....#.#.#.#...#.#.#
###.#.#.#.#######.#.#
#.#.#.#.#.......#.#.#
#.#.###.###.#.#.#####
#.#.......#.#.#.....#
#######.#######.#.###
#.............#.#...#
#.#.###.#.#.#.#.#.#.#
#.#....S#.#.#.#.#.#.#
#.###.###.#####.#.###
#...#...#.....#.#...#
###.#############.#.#
#.#.............#.#.#
#.###.###############
#...#...............#
#########.#.###.#####
#.......#.#...#.....#
#.#.#############.###
#.#.............#...#
#.###.#.###.#######.#
#...#.#...#.......#.#
#####################
