#####################
#.....#.............#
###.#.#.###.#######.#
#...#.#.#.#.#...#...#
#.#####.#.#.#.#.#.###
#.#.....#.#.#.#.....#
#.#.#####.#.#########
#.#.#..E#.#.........#
#.#.#.#.#.#########.#
#...#.#.....#.......#
#.###.###.###.#####.#
#.....#.#.#...#...#.#
#######.#.#.#####.#.#
#.......#.#.....#...#
#.#.#####.#####.#####
#.#.......#.#...#...#
#.#########.#.###.#.#
#...#.#.....#...#.#.#
###.#.#.###.###.#.#.#
#.#.#.....#...#...#S#
#.#.#######.#.#######
#...........#.......#
#####################
