#####################
#...................#
#.#.###.###.###.#####
#.#...#...#...#.....#
#####.###.#.###.#.###
#...#...#.#...#.#...#
###.#####.###.###.#.#
#.#S....#...#...#.#.#
#.###.#.#######.#.#.#
#...#.#.......#.#.#.#
#.###.###.#.###.#####
#...#...#.#...#.....#
#####.###.###.###.###
#...#...#...#...#...#
#.#######.###.#######
#.......#...#.......#
#####.###.###.#.#####
#...#...#...#.#.....#
#####.###.#.###.#.###
#...#...#.#..E#.#...#
#####################
