#####################
#...........#.#.....#
#.#####.###.#.#.###.#
#.....#...#...#.#...#
#####.###.#####.#.###
#.#...#.#.......#.#.#
#.#.###.#########.#.#
#.#.#.....#.....#S#.#
#.#.#.#.###.#.#####.#
#...#.#.....#...#...#
#.###########.#.#.#.#
#.......#...#.#...#.#
#######.#.#.#######.#
#...#...#.#...#...#.#
#.#.#.###.###.#.#.#.#
#.#.#.#...#.#...#.#.#
#.###.#.###.#####.#.#
#...#.#...#.....#.#.#
###.#.###.#.#.#.#.#.#
#...#.....#.#.#.#.#.#
#.#########.#.###.#.#
#....E..#...#.....#.#
#.#.###.#.#########.#
#.#.#...#.#.......#.#
#.#.#####.#####.#.#.#
#.#.............#...#
#####################
