#####################
#...................#
###.#.#######.#####.#
#.#.#.......#.....#.#
#####.#####.###.###.#
#...#.....#...#...#.#
###.###.###.#.#.#.#.#
#.#...#...#S..#.#.#.#
###.#######.#.#######
#.#.......#.........#
#####.#.#.#.#.###.###
#...#.#.#.#.#...#...#
#.#.#.#.#.#.#.#.#.#.#
#.#.#.#.#.#.#.#.#.#.#
#.#######.#.#.#.#####
#.......#.#...#.....#
#####.#.#.#.#.###.###
#...#.#.#.#.....#...#
#.#######.###.#.#.###
#.......#.....#.#...#
#.###.###.#.#.#####.#
#...#...#.#.......#.#
#######.#.#.#.###.#.#
#.....#.#.#.....#.#.#
#.###.###.#.#.#####.#
#...#...#.#..E....#.#
#####.#######.###.#.#
#...#.......#...#.#.#
#.#.#######.#######.#
#.#.......#.......#.#
#####################
