#####################
#...........#.......#
###.#.#####.#.###.#.#
#...#.#.#...#.#...#.#
###.###.#####.###.###
#.#...#.#.....#.....#
#.#.#.#.#.#######.###
#...#.......#.#...#.#
###.###.#.###.#.###.#
#...#...#...#.......#
#.#.###############.#
#.#.....#.......#.#.#
###.###.#.#.###.#.###
#...#.....#...#...#.#
#####.#######.#####.#
#...........#.#.....#
###.#####.#####.###.#
#...#...#.#.#.....#.#
#.#.#.#.###.###.###.#
#.#.#.#...#...#.#...#
###.#.#######.#.#.###
#.......#...#.#.#...#
#######.###.#.#.#####
#...............#...#
#.#.###.###########.#
#.#..E#.#.#.........#
#.#.#.#.#.###.#####.#
#.#.#.#...#.......#.#
#.###.###.#.###.#.###
#...#.#.......#.#..S#
#####################
