#####################
#.....#.........#...#
###.#.#####.###.#.#.#
#...#.....#...#.#.#.#
#.#######.###.#.###.#
#...#.........#...#.#
###.###.#########.#.#
#.#...#.#S#.....#.#.#
#.###.#.#.#.#.###.#.#
#...#.#.#.#.#.....#.#
#.#.#.###.#.#######.#
#.#.#.....#.#.#.....#
###.#######.#.#.###.#
#.........#.#.#...#.#
#.#.#####.#.#.###.#.#
#.#.#...#.#.#.....#.#
#.###.#.#.#.#.#####.#
#.#...#.#.#.#.#...#.#
#.#.###.###.#.#.#.#.#
#.#...#.....#.#.#.#.#
#.###.#########.#.#.#
#...#.....#.....#...#
#.#.#####.#.#######.#
#.#.......#.....#...#
#.#############.#.###
#.#...#.........#...#
#.#.#.#####.#######.#
#...#.#.....#.#.....#
#####.#.#####.#.#####
#..E....#...........#
#####################
