#####################
#...................#
#####.###.#######.#.#
#...#...#.......#.#.#
#.#.#######.#.###.#.#
#.#.......#.#...#.#.#
#.#.#.###.###.#.###.#
#.#.#E..#...#.#...#.#
#.#####.#########.#.#
#.....#.........#.#.#
#.#.#.#.#####.#.###.#
#.#.#.#.....#.#...#.#
#########.#.#.#.#.###
#.......#.#.#.#.#...#
#.#######.#.#####.#.#
#.......#.#.....#.#.#
#####.#.#.#.#######.#
#...#.#.#.#.......#.#
###.#.#.#######.#.###
#.#.#.#.......#S#...#
###.#.#.###########.#
#.#.#.#...........#.#
#.#####.#####.#.###.#
#.....#.....#.#...#.#
#.#.#.#########.###.#
#.#.#.........#...#.#
###.#########.#.###.#
#.#.........#.#...#.#
###.#.#.#.#######.###
#.#.#.#.#.......#...#
#####################
