#####################
#................S..#
#.#######.###.###.#.#
#.......#...#...#.#.#
#.#.###.#####.#.#####
#.#...#.....#.#.....#
#.#####.#############
#.....#.............#
###.###.###.#######.#
#.#...#...#.......#.#
#######.#########.###
#.....#.........#...#
#####.#.#####.#.#####
#...#.#.....#.#.....#
#.#######.###.#.###.#
#.......#...#.#...#.#
###.#.###.#.#.#.#.###
#.#.#...#.#.#.#.#...#
#.#########.#####.#.#
#.........#.....#.#.#
#.#.#########.#.#.###
#.#.........#.#.#...#
#####.#.#.#######.#.#
#...#.#.#.......#E#.#
###.###.#####.###.###
#.#...#.....#...#...#
#.#.#####.#####.#.###
#.#.....#.....#.#...#
###.#.###########.###
#.#.#...........#...#
#####################
