#####################
#.....#.....#S#.....#
#.#.###.#.###.#.#.###
#.#.#...#...#.#.#...#
#.###.#####.#.#####.#
#...#...#.#...#.....#
#.#.###.#.#####.###.#
#.#...#.#.......#.#.#
###.#.#.#.#######.#.#
#...#.#...#.......#.#
#.###.#####.#####.#.#
#.#.#.#...#...#.#.#.#
#.#.#.###.###.#.#.#.#
#.#.......#.#...#...#
#.#######.#.###.#####
#..E....#.#...#.#...#
#######.#.#.###.#.#.#
#.....#.#...#...#.#.#
#.###.#.###.#.###.#.#
#...#.#.#.#.#.#...#.#
###.#.#.#.#.#.#####.#
#...#...#...#...#...#
#.#######.#####.#.#.#
#.#...#...#.....#.#.#
#.#.###.###.#####.#.#
#.#.......#...#...#.#
#.###.#######.###.#.#
#...#...#...#.....#.#
#.#.#####.#.#######.#
#.#.......#.........#
#####################
