#####################
#S........#.......#.#
#####.###.#.###.#.#.#
#.#...#.#.#...#.#...#
#.#####.#.#.#####.#.#
#.#.....#...#...#.#.#
#.#.#.###.###.###.###
#.#.#.#.#.#.....#...#
#.###.#.#.#.###.#####
#.#...#...#...#.....#
#.###.#.###.###.#####
#.......#...#...#.#.#
#.#####.#####.###.#.#
#.....#.#...#...#.#.#
#.#.###.###.###.#.#.#
#.#...#...........#.#
#.###.#####.#.#####.#
#...#.#.....#.#...#.#
#########.#####.###.#
#.#.......#...#..E..#
#.#.#.#######.###.###
#...#...#...#...#...#
#######.#.#####.#.###
#.#.........#.....#.#
#.#.#######.#.###.#.#
#.#.....#.#.#...#...#
#.#######.#.#.#####.#
#.......#.....#...#.#
#.#####.#.#####.#.###
#.#.............#...#
#####################
