#####################
#.......#.#...#.....#
#.#.#####.#.###.#.###
#.#...#.#.#.....#...#
###.###.#.#.###.#.###
#.#.......#.#...#.#.#
#.#.###.###.#.#####.#
#...#...#...#...#...#
#######.#.#.#######.#
#.#.....#.#...#...#.#
#.#.#####.#.#####.#.#
#...#.#.#.#...#.....#
#.#.#.#.#.###.#.###.#
#.#.....#.#...#...#.#
###.###.#.###.#####.#
#...#.#.#.#.........#
#####.#.#.#.#####.###
#S........#.#...#.#.#
###.###.#.#.#.###.#.#
#...#.#.#.#.#.#.#...#
#.#.#.###.###.#.#.#.#
#.#.#...........#.#.#
#.#######.###.#####.#
#...#.#...#...#.....#
#.###.#####.#.###.###
#...#.......#...#...#
#.#.#.###.###.#######
#.#.#.#.#...#.#...#.#
###.###.#.#####.###.#
#.....#....E........#
#####################
