#####################
#.........#...#.....#
#.#.#####.#.###.#.#.#
#.#.....#.#.#...#.#.#
#.#####.#.#.#.###.#.#
#.....#.#E#...#...#.#
#####.#.#.###.#.###.#
#.#...#.#...#.#...#.#
#.#.###.###.#.###.#.#
#...#...#.#.#...#.#.#
#.###.###.#.#####.###
#.#...#...#.....#...#
#.#.###.#######.###.#
#.#.#.........#.....#
#.#.#######.#######.#
#.#.......#.........#
#.#######.###.#######
#.......#...#.......#
###########.#########
#...........#.....#S#
#.#########.#.###.#.#
#.#.......#.#...#...#
#.#.#####.#.###.#####
#.#.....#.....#.#...#
#.#############.#.#.#
#.#...#.......#...#.#
#.#.#.#.#####.#####.#
#...#.#.....#.....#.#
#.###.#####.#.#####.#
#...#.......#.......#
#####################
