#######################
#........E......#.....#
#.#########.###.#####.#
#.#.....#...#.......#.#
#.#.###.#.#########.#.#
#.#.#.....#...#...#...#
#.#.###.###.#.#.#####.#
#.#...#.#...#.#.#.....#
#####.###.###.#.#.#####
#.....#.....#.#...#S..#
#.#####.#####.#.#####.#
#.#.....#.#...#.....#.#
#.#.#####.#.#########.#
#...#.....#.#.........#
#.#######.#.#.#########
#.#.....#.#.#.#.....#.#
#.#.###.#.#.#.#.###.#.#
#...#.....#.....#.....#
#######################
