#######################
#S....#...#.....#.#.#.#
###.###.#.#####.#.#.#.#
#.#.....#.#.#.........#
#.#.#####.#.###.#.###.#
#.#.#...#...#...#.#.#.#
#.###.#####.#####.#.#.#
#.#...#.....#...#...#.#
#.#.###.#####.#####.#.#
#.#.#....E..#.#...#.#.#
#.#.#######.#.#.#.###.#
#.......#.....#.#.....#
#.#.#.#####.#.#####.#.#
#.#.#.#.....#.#.....#.#
#.#######.#.#.#.#.#####
#...#.....#.#...#.....#
###.#.#######.#.###.#.#
#.........#...#...#.#.#
#######################
