#######################
#.....#.......#.......#
#####.#.###.###.#####.#
#.#.#...#.#.#.#...#...#
#.#.#.#.#.#.#.#.#.#####
#.#.#E#.#.......#.#...#
#.#.###.#####.#####.###
#...#.#.....#...#.....#
#.#.#.#.#######.#.###.#
#.#.....#.....#.#.#...#
#.#####.###.#.#.#####.#
#.#.#.#.#...#.........#
#.#.#.###.###.#####.###
#.......#...#...#S....#
#######################
