#######################
#.........#...........#
###.#####.#########.#.#
#...#...#.#.......#.#.#
#.###.###.#.#####.#.###
#.#.........#...#.#...#
#.###.#######.#.#.#.#.#
#...#.#S#...#.#.#.#.#.#
#.#.###.#.#.#.#.#.###.#
#.#.....#.#...#......E#
#######################
