#######################
#.....................#
#.#.###.###.#.###.###.#
#.#...#..........E..#.#
#########.###.###.###.#
#.......#...#...#...#.#
#########.###.#.#.#.#.#
#.......#...#.#.#.#.#.#
#.#.#.###.#######.#.#.#
#.#.#....S......#.#.#.#
#######################
