#######################
#......E..............#
###.###.#####.#.###.#.#
#.#...#.....#.#...#.#.#
#.###.#.###.###.#.#.###
#...#.#...#...#.#.#...#
#####.###.###.#.#.#####
#...#...#...#.#.#.....#
###.#.#######.###.###.#
#.#.#.......#...#...#.#
#####.#####.#.#.###.###
#...#....S#.#.#...#...#
#######################
