#######################
#..............S......#
#.###.#.#.###.###.#####
#...#.#.#...#...#.....#
#####.#.#.###.#.#.#####
#...#.#.#...#.#.#.....#
#.#.###.###########.###
#.#...#...........#...#
#######.#.#####.#####.#
#.....#.#..E..#.....#.#
#########.#.###.#######
#.......#.#...#.......#
#.###.#########.#.#.#.#
#...#.........#.#.#.#.#
#######.#.#######.###.#
#.....#.#.......#...#.#
###.#.#.#.#.#####.#####
#.#.#.#.#.#.....#.....#
#######################
