#######################
#.......#............E#
#.#####.#.###.#.#####.#
#.....#...#.#.#.#.....#
#.#.#######.#.#.#######
#S#.#.....#.#.#.....#.#
###.#.###.#.#.#######.#
#.#.....#.#.....#.....#
#.#####.###.###.#.#.###
#.......#...#.....#...#
#######################
