#######################
#.....................#
###.#.#######.#.###.###
#.#.#.......#.#...#...#
#.###.#.#######.###.#.#
#...#.#.......#...#.#.#
#.###.###.###.#.#.#.#.#
#...#...#...#.#.#.#.#.#
###.#.#.#####.#####.#.#
#.#.#.#.....#.....#.#.#
###.#.#####.#.#######.#
#.#S................#.#
#.###.###.#####.###.#.#
#...#...#.....#E..#.#.#
#######.#########.###.#
#.....#.........#...#.#
#######################
