#######################
#.#S#...#...#.#.#.#.#.#
#.#.#.#.#.#.#.#.#.#.#.#
#.....#...#...........#
#.#########.#.#####.#.#
#.....#.#.#.#.#.#...#.#
#######.#.#.###.#######
#.......#.....#...#...#
###.#.#.###.#####.#.###
#...#.#.#.#.....#...#.#
#.###.#.#.#.#.#.#.#.#.#
#.#...#.....#.#...#E..#
#######################
