#######################
#.....................#
#########.#####.#.###.#
#.......#.....#.#...#.#
#####.#.###.#.#######.#
#...#.#...#.#.......#.#
#######.###.#.###.#####
#.....#...#.#...#.....#
#########.#.#.#.#.#.###
#.......#.#.#.#.#.#...#
#.#####.#####.###.###.#
#.....#..............S#
###.#######.###.#######
#.#.......#E..#.......#
###.###.#####.#.#####.#
#.#...#.....#.#.....#.#
###.#####.###.###.#.#.#
#.#.....#...#...#.#.#.#
#######################
