#######################
#.....#.#.....#.....#E#
###.###.###.###.###.#.#
#...#.......#...#.....#
#.#####.#.#######.#####
#.#.....#...#S....#.#.#
#.#.#.#.#######.###.#.#
#...#.#.....#.........#
#.#####.###.###.#####.#
#.....#...#...#.#.....#
#####.#.#.###.#.#.###.#
#.....#.#.#.....#.#...#
#######################
