#######################
#...#.#.......#.......#
#.###.#####.#####.###.#
#...#.....#.......#.#.#
###.###.###.#######.#.#
#.#...........#.....#.#
#.###.#.#####.#.#####.#
#...#.#.#S#.#.#.#.#E..#
###.#.#.#.#.#.#.#.#.###
#.....#.#.#...#.......#
#.###.###.###.#######.#
#...#.#...........#...#
#######################
