#######################
#.#.#.#.....#.#.#.....#
#.#.#.#.###.#.#.###.#.#
#.......#.#.........#.#
#####.###.###.#####.###
#....E#.....#.#.......#
#.###.#.###.#####.#.###
#.#.......#.....#.#...#
#.###.#.#.#####.#####.#
#...#.#.#.#...#...#...#
###.###.#####.#.#.###.#
#...#.#.#.......#.#.#.#
#####.#.###.#####.#.#.#
#.......#S....#...#...#
#######################
