#######################
#.....................#
#.#.#.#####.#.#####.#.#
#.#.#....S#.#.....#.#.#
#######.#.###.#.#####.#
#.......#...#.#.....#.#
#.#####.#.#.###.###.#.#
#.....#.#.#...#...#.#.#
#.#.###.#######.#.#.###
#.#...........#.#.#...#
#######.#.#.###.#.###.#
#.....#E#.#...#.#...#.#
###.#######.#.#.#.###.#
#.#.......#.#.#.#...#.#
#######################
