#######################
#....................S#
#.#.#.#.###.###.#######
#E#.#.#...#...#.......#
###.#.###.#.#.###.#####
#.#.#...#.#.#...#.....#
#####.#####.###.###.###
#...#.....#...#...#...#
#.#.###.#######.#.#.#.#
#.#...#.......#.#.#.#.#
#.#####.#.###########.#
#.....#.#...........#.#
#######################
