#######################
#.....................#
#.#######.#.#.#########
#....S..#.#.#.........#
###########.#####.#.###
#.........#.....#.#...#
#.#.#.#######.#.#.#.#.#
#.#.#.......#E#.#.#.#.#
#.#.#.#.#.#########.###
#.#.#.#.#.........#...#
#######################
