#######################
#.....#.......#..S#...#
#.#####.#.#####.###.#.#
#.#.....#...#...#...#.#
#.#.#######.#.###.###.#
#.#...#...#.#.#...#.#.#
#.###.#.#.#.#.#.###.#.#
#.#...#.#.#.#...#...#.#
#.#.###.#.#.#####.#.#.#
#.#.#...#.#.....#.#...#
#.#.#.#.#.###.###.#####
#.#.#.#.#.#.#...#.#...#
#.#.###.#.#.###.#.###.#
#.......#....E#.......#
#######################
