#######################
#.........#...#.......#
#.#.#.#####.#.###.#.#.#
#.#.#.#.....#...#.#.#.#
#.#.###.#######.#.#.#.#
#.#.#...#.....#.#.#.#.#
###.#.###.###.#.###.###
#...#E#...#...#...#...#
#.###.#.###.#.###.###.#
#.....#.#.#.#.#.#.#...#
#.#####.#.#.#.#.#.#.###
#.#.....#.#.#...#S#...#
#.#####.#.#.#########.#
#.....#...#...........#
#####.#########.#####.#
#...............#.....#
#######################
