#######################
#.#...#.........#...#.#
#.#.###.#######.###.#.#
#.......#...#...#.....#
#######.#.###.#.#.#####
#...........#.#E#.#...#
###.#.###.#.#####.###.#
#.#.#...#.#...........#
#.###.#########.#####.#
#.........#.........#S#
#######################
