#######################
#.#.......#.......#...#
#.#.#.###.###.###.#.#.#
#...#.#.......#.#.#.#.#
#.###.#########.#.###.#
#.#...#....S#...#.....#
#.#.###.#####.#######.#
#.#.#...#.........#...#
###.#.###.#####.###.###
#...#E..#.#...#.....#.#
#.#####.#.#.#.#######.#
#.#.....#.#.#.........#
#.#.#####.###.#######.#
#...#.........#.......#
#######################
