#######################
#.....................#
#####.#.#.#.#.#####.###
#..E..................#
###.###.#####.#.###.#.#
#.#...#.....#.#...#.#.#
###.###.###.###.#.###.#
#.#...#...#...#.#...#.#
#.###.#.###.#.#####.#.#
#...#.#...#.#.....#...#
###########.#.#.#####.#
#.........#.#.#.....#S#
#.#.#######.#.#####.#.#
#.#.......#.#.....#.#.#
#############.#########
#...........#.........#
#######################
