#######################
#.....................#
#.#.###########.#####.#
#.#...........#.#...#.#
#.###########.###.#.#.#
#.......#...#.#...#S#.#
#######.###.#.#.#######
#.#...#...#.#.#.......#
#.#.#.###.#.#.#######.#
#...#E......#.........#
#######################
