#######################
#...#.......#.........#
###.#.###.###.#######.#
#.....#...#.#...#.#S..#
#####.#.###.#####.###.#
#.#...#...#...........#
#.#######.#.#######.###
#.....#.....#.#.#.#...#
#.#######.###.#.#.###.#
#.......#.....#.#.....#
#####.###.#####.#####.#
#...#...#.#...#.#...#.#
###.#.###.#.#.#.#.#.#.#
#.#...#.....#...#.#.#.#
#.#.###.#.#.#####.#.#.#
#.#.....#.#...#...#..E#
#.###.#.###.###.###.#.#
#.....#.#...#.....#.#.#
#######################
