#######################
#...#.#.#.....#.......#
#.#.#.#.###.###.#.###.#
#.#.#...#.......#...#.#
#.###.#.#####.#####.###
#....E#...........#.#S#
#####.#.#####.#.#####.#
#...#.#.#.#...#.......#
###.#####.#.#######.###
#...#.....#.#.....#...#
#.###.#.#######.#.###.#
#.....#.........#.....#
#.#######.###.#####.###
#.....#...#.....#.....#
#######################
