#######################
#S#.........#...#.....#
#.###.#####.#.#.#####.#
#...#.#...#...#.#.....#
###.#.###.#####.#.###.#
#.#...#...#...#...#...#
#.#####.###.#.#####.###
#...#.....#.#...#...#.#
#.#.#.###.#.#.###.###.#
#.#...#.#...#.....#...#
#.#####.###########.#.#
#.#...........#.....#.#
#.#.#########.###.###.#
#...#.......#...#.#.#.#
#####.#####.###.#.#.#.#
#.........#.......#..E#
#######################
