#######################
#E......#...........#.#
#.#.###.#####.#####.#.#
#.#.#...#.....#...#.#.#
###.#.###.#######.#.#.#
#...#.....#.......#.#.#
#.#.#######.#####.#.#.#
#.#.#....S#.....#.#.#.#
#.#.#.#####.###.#.#.#.#
#.#.#.#...#.#.#.#.#...#
#.###.#.#.#.#.#.#####.#
#.....#.#.....#.......#
#######################
