#######################
#.....................#
#.###.#.#.###.#####.#.#
#...#.#.#...#.....#S#.#
#.#.#####.#####.#.#.###
#.#.....#.....#.#.#...#
#.#########.#.#.#.###.#
#.........#.#E#.#...#.#
#.###.###.###.#.#.#.###
#...#...#...#.#.#.#...#
#####.###.#############
#...#...#.............#
#.#.#.#########.#.#.#.#
#.#.#.........#.#.#.#.#
#######################
