#######################
#...#.#.....#.....#...#
#.#.#.#.###.#.###.###.#
#E#...#.#...#.#.....#.#
#.###.#.#.###.#####.#.#
#.#...#.#...#.....#.#.#
#.#####.###.#####.#.#.#
#.#.....#.#.#.....#.#.#
#.#.#####.#.#.#####.#.#
#...#.....#.#.....#...#
#.#####.#.#.#####.###.#
#.#...#.#.#.....#...#.#
#.#.#.###.#####.###.#.#
#.#.#...#...#...#.#S#.#
#.#.###.#.#.#.#.#.###.#
#.#...#.#.#.#.#...#...#
#.###.#.#.#.#.#####.###
#.....#...#.#.........#
#######################
