#######################
#.....................#
###.###.#.#.###.#.###.#
#............E#.#...#.#
#.#.###.#######.#######
#.#...#.......#.......#
#.#######.#####.#.#####
#.......#.....#.#.....#
#.#.#.#.###########.###
#S#.#.#...........#...#
#######################
