#######################
#.....................#
#.#.#######.#.#.###.###
#.#.......#.#.#...#...#
#.###.#######.#######.#
#...#.......#.......#.#
#.#######.#.###.#.###.#
#....S..#.#...#.#...#.#
#.#####.#####.###.#####
#.....#.....#...#.....#
#.#.###.#.#.#.#.###.#.#
#.#...#.#.#.#.#...#.#.#
#.###.#.#.#.###.#.#.#.#
#...#.#.#.#...#.#.#.#.#
#.#.###.###.#.###.#####
#E#...#...#.#...#.....#
#######################
