#######################
#.....................#
#.#.#.###.###.#.#######
#.#.#...#...#.#..S....#
#######.###########.###
#.....#...........#...#
#.#.###.###.###########
#.#...#...#...........#
#.#.#.#.#.###.#######.#
#.#.#.#.#E..#.......#.#
###.#.#####.#.###.#.#.#
#.#.#.....#.#...#.#.#.#
#######.#.###.#####.#.#
#.....#.#...#.....#.#.#
#.#.###.#.#.###########
#.#...#.#.#...........#
###########.#####.###.#
#.........#.....#...#.#
#######################
