#######################
#...#...#..S#.#.......#
#.###.#.#.###.#.#####.#
#.....#...#.....#.#...#
#.###########.###.#.###
#.#...#.....#.....#...#
#.#.#.#.###.#.#######.#
#E..#...#.#.#.#.......#
#########.#.###.#####.#
#...............#.....#
#######################
