#######################
#.#.#...#...#.........#
#.#.#.#.#.#########.#.#
#.#...#...#S......#.#.#
#.###.#.#######.###.#.#
#.....#.#...#...#.#.#.#
#.###.#.#.#####.#.###.#
#.#...#...#.#.....#E..#
###.#.#.###.#####.###.#
#...#.#...#...#.#.#...#
#.#.#####.###.#.#.###.#
#.#.#.......#.#.....#.#
#.#####.###.#.#.#.###.#
#.....#...#.#...#.....#
#.#####.###.###.#.#.###
#.....#...#.....#.#...#
#######################
