#######################
#.......#.....#.......#
#.###.###.###.#.#####.#
#...#.#...#.#.#.#...#.#
#.#.#.#.###.#.#.#.#.#.#
#.#.#.#.#...#.#.#.#.#.#
###.###.###.#.#.###.#.#
#...#.......#E......#.#
#.###.###############.#
#.#...#...#...#.....#.#
#.#.###.#.#.#.#.###.#.#
#...#.#S#.#.#.#...#...#
#.###.###.#.#.###.###.#
#.......#...#.....#...#
#######################
