#######################
#.....................#
###.###.#.#.#########.#
#.#S..#.#.#.........#.#
#####.#.#.#.###.#.#.#.#
#...#.#.#.#...#.#.#.#.#
###.#.###.#.#.#.#.###.#
#.#.#...#.#.#.#.#...#.#
#.###.#.#####.#######.#
#...#.#.....#.......#.#
###.#.#####.#####.#.###
#.#.#.....#..E..#.#...#
#.#.###.###.#.#.###.###
#.#...#...#.#.#...#...#
#######################
