#######################
#.....#.#.........#...#
#####.#.#.#.#####.###.#
#.......#.#...#...#...#
#.#.#####.#####.#####.#
#.#E#.#...#.#.#.......#
#.#.#.#.#.#.#.#.#.#####
#.#.....#.....#.#.#.#.#
###.###.#########.#.#.#
#.....#...#.....#.#...#
###.#########.#.#.#.###
#.......#S....#.....#.#
###.#########.###.###.#
#.#...#...#.....#.....#
#.#.###.#.###.###.#.###
#.....#.#.....#...#...#
#######################
