#######################
#........S............#
#.#.###.###.#.#.#.###.#
#.#...#...#.#.#.#...#.#
#.#############.#.#.#.#
#.............#.#.#.#.#
#.#####.###.#.#####.###
#E....#...#.#.....#...#
###.###.#####.#####.#.#
#.#...#.....#.....#.#.#
###.###.###.#####.#.###
#.#...#...#.....#.#...#
#######################
