#######################
#.....................#
#.###############.###.#
#.......#..E#...#...#.#
#######.#.#.#.#.#####.#
#.....#.#.#.#.#...#...#
#.###.#.#.###.###.#.#.#
#.#...#...#...#.#...#.#
#.#######.#.###.#####.#
#.#.....#.#...#.......#
#.#.#.###.###.#.#######
#...#.....#...#...#..S#
#.#########.#.#####.###
#...#...#.#.#.#...#.#.#
###.#.#.#.#.###.#.#.#.#
#.....#...#.....#.....#
#######################
