#######################
#.....#...........#...#
#.#.###.#########.#.#.#
#.#.....#.#...#S..#.#.#
#.#######.#.#.#####.#.#
#.....#.....#.......#.#
#####.#.#######.#####.#
#.....#.#.......#.....#
#.#######.#######.#####
#.#.....#.#.#...#.#...#
#.#.###.#.#.#.#.#.#.#.#
#...#.....#...#.....#E#
#######################
