#######################
#S....#.....#...#..E..#
###.###.#.###.#.###.#.#
#.......#...#.#...#.#.#
###.#.#.#.#.###.#.###.#
#.#.#.#.#.#.....#.....#
#.#.#####.###.#.###.###
#...#.......#.#...#.#.#
#.#.#.#######.#######.#
#.#.#.....#...........#
#######################
