#######################
#.....................#
#.###.#############.#.#
#...#.............#S#.#
###.#.###.#########.###
#.#.#...#.........#...#
#.#######.#####.###.#.#
#.......#.....#...#.#.#
#####.#.###.#.#.#######
#...#.#...#.#.#.......#
#.#.#.#######.#.###.###
#.#.#.......#.#...#...#
#.###.###.#.###.#.#.#.#
#...#...#.#...#.#.#.#.#
#.#.###.#.#.#####.#####
#.#...#.#.#.....#..E..#
#.###.#.#.#.#.#.#######
#...#.#.#.#.#.#.......#
###.#.###########.#.###
#.#.#...........#.#...#
#######################
