#######################
#.....#...#.....#...#.#
###.###.#.#####.#.###.#
#.......#.......#...#.#
#####.#######.#.#.###.#
#.......#.#.#.#...#.#.#
###.###.#.#.###.###.#.#
#S#...#.#.....#.....#.#
#.###.###.#######.###.#
#.....#...#.#...#...#.#
#####.#.#.#.###.#.#.#.#
#.....#.#.#...#.#.#...#
#.#.#.#.###.###.###.#.#
#.#.#.#...........#.#.#
#####.###.#.###.#.#.#.#
#...#...#.#.#...#...#.#
#.###.#.#########.###.#
#.#.#.#...#.#.#...#.#.#
#.#.#######.#.###.#.#.#
#.#.#.....#.......#.#.#
#.#.#.#.#.#.#.#.#.#.#.#
#.....#.#...#.#E#...#.#
#######################
