#######################
#.....................#
###.###.#.#.#.#######.#
#.#...#.#.#.#.......#.#
#.###.#######.#.#####.#
#...#.......#.#.....#.#
#######.#.#.###.#######
#.....#.#.#...#.......#
#####.#.#.#.#.#.#.###.#
#...#.#.#.#.#.#.#...#.#
#.#.#.#########.#####.#
#.#.#.........#.....#.#
#############.###.#.###
#...........#....E#...#
#######.#.###.#####.###
#.....#.#...#.....#...#
#######.#.###.#######.#
#.....#.#...........#.#
#.###.###.#.#.###.###.#
#...#...#.#.....#...#.#
#.#######.###.#.#.#####
#.......#.....#.#.....#
#####.#######.#.#.#.###
#...#.........#.#.#...#
###.###.#.###.#######.#
#.#...#.#...#S......#.#
###.#######.#.###.#####
#.#.......#.#...#.....#
#######################
