#######################
#.......#.....#.#.....#
#####.#.#.###.#.#.###.#
#...#.#.#...#.#....E#.#
#.#.#.#.#.###.#.#####.#
#.#...#.#.#...#...#...#
#.#######.#.#######.#.#
#...#.....#.#.....#.#.#
#.#.#.#####.###.#.#.#.#
#.#...#...#...#.#...#.#
#.#####.#####.#.#####.#
#.....#.....#.#.....#.#
#####.###.###.#####.#.#
#...#.#...#...#..S#.#.#
#.###.#.#.#.###.###.#.#
#.#...#.#.#.....#...#.#
#.#.###.#########.#####
#.#.#.......#...#.....#
#.#.#####.#.#.#.#####.#
#.........#...#.......#
#######################
