#######################
#.......#.......#.....#
###.###.#.###.###.###.#
#...#...#...#.......#.#
#.###.#####.#########.#
#.#.......#.#...#...#.#
#.#.#####.#.###.#.#.#.#
#.#.#...#.#...#.#.#...#
#.###.#.#####.#.#.#####
#.....#.#...#...#..E..#
#.#####.#.#.###.#####.#
#...#.#...#...#.#.#...#
###.#.#####.#.#.#.#.###
#.#.#.....#.#.#...#...#
#.#.###.###.#####.###.#
#.#.#...#S#...#.....#.#
#.#.#.###.###.#.#####.#
#.....#...#...#.#.#...#
#.#####.###.###.#.#.###
#.#.#...#...#.....#...#
#.#.#.#####.#.#######.#
#...#.....#...#.....#.#
###.#####.#####.###.#.#
#.......#.......#.....#
#######################
