#######################
#..E..................#
#############.###.#.###
#...............#.#...#
#.#.#####.###.#.#.#####
#.#.....#....S#.#.....#
#.###.#.#######.#.###.#
#...#.#.......#.#...#.#
#######.###.#.#.#.#.#.#
#.....#...#.#.#.#.#.#.#
#####.###########.#####
#...#...........#.....#
###.###.###.#.#.#######
#.#...#...#.#.#.......#
#.###.###.#.###.#.###.#
#...#...#.#...#.#...#.#
#######.###.#.#.#.#.###
#.....#...#.#.#.#.#...#
#.#######.#####.#.#####
#.......#.....#.#.....#
#######################
