#######################
#.....................#
###.#.#.#####.#.#.#.#.#
#.#.#.#.....#.#.#.#.#.#
###.###.#.#.#####.#####
#.#...#.#.#.....#.....#
#.#.#.#####.###.#.###.#
#.#E......#...#.#...#.#
#.#.#####.#.#####.#.###
#.#.......#.....#.#...#
#####.#.#.###.#.###.###
#...#.#.....#.#...#...#
#######.#.#######.###.#
#.....#.#.......#...#.#
#.#####.#.#.#######.#.#
#.....#...#.......#.#.#
#.#.###.#.#.###.#####.#
#.#...#...#...#.....#.#
#.#######.#####.#.#.###
#........S....#.#.#...#
###.#####.#.#####.#####
#.#.....#.#.....#.....#
#.###.#####.#.#.#.###.#
#...#.....#.#.#.#...#.#
#####.#.#.#.###.###.###
#...#.#.#.#...#...#...#
#######################
