#######################
#............E........#
#.###.#.#.#.#.#.#.#.#.#
#...#.#.#.#.#.#.#.#.#.#
###.#.###.#.#.#########
#.#.#...#.#.#.........#
###.#####.#.###.#.#.#.#
#.#.....#.#...#.#.#.#.#
#.###.#######.#.#.###.#
#...#.......#.#.#...#.#
#.#.#.#####.###.###.#.#
#.#.#.....#...#...#.#.#
#####.#######.#.#######
#...#.......#.#.......#
#.#.#.###.###.#.#.#####
#.#.#...#...#.#.#.....#
#####.#####.###.#.#####
#...#.....#...#S#.....#
#.###.#.#.#.#.#.#.#.###
#...#.#.#.#.#.#.#.#...#
#.#.#########.#.#.#.###
#.#.........#.#.#.#...#
#####.#.#.#####.#.###.#
#...#.#.#.....#.#...#.#
#######################
