#######################
#.....................#
###.#.#####.#.#.#.#.###
#.#.#.....#.#.#.#.#...#
#.###.###.###.#.###.###
#...#...#...#.#...#...#
###########.#.#####.###
#.........#.#.....#...#
#.#####.#.#.#.###.#####
#........S#.#...#.....#
###.#################.#
#...................#.#
###.#.#####.#####.#.###
#...#.....#.....#.#...#
#.#.#.###########.###.#
#.#.#...........#...#.#
###.#.#.#.#######.###.#
#...#.#.#.......#...#.#
#.#.#####.#.#######.###
#.#.....#.#.......#...#
###.###.###.#####.#.#.#
#..E..#...#.....#.#.#.#
#######################
