#######################
#.....#.....#...#.....#
#.###.#.###.#.#.#.###.#
#.#.....#.#.#.#S#...#.#
#.#######.#.#.###.#.###
#.#.....#...#.#...#...#
#.#.###.#.###.#######.#
#.#.#.#.#...#.......#.#
#.#.#.#.###########.#.#
#.#..E#.........#...#.#
#.###.#######.#.#.###.#
#...#.......#.#.#.#...#
#.#########.#.#.#.#.#.#
#.#.......#.#.#.#.#.#.#
#.#.#####.#.#.###.###.#
#.#.#...#...#.#...#...#
#.#.###.#####.#.###.#.#
#...#.......#...#...#.#
#.###.#####.#####.###.#
#.....#...........#...#
#######################
