#######################
#.#...........#.....#.#
#.#.#.#.###.###.###.#.#
#...#.#.#.........#...#
#.#####.###.#.#.#.#.###
#.#...#.#.#.#.#.#.#.#.#
#####.###.#.#######.#.#
#.#S......#.#.#.......#
#.#####.###.#.#######.#
#...#...#...#.#.....#.#
#.#.###.###.#.#.###.###
#.#.........#.#...#...#
###.###.###.#.#####.###
#...#.....#.#.........#
###.#.#.#############.#
#...#.#...#...#.#.....#
#.#.#.#.###.###.#.#####
#.#.#.#.#........E....#
#######.###.#.#.#.#.###
#.#.#.......#.#.#.#...#
#.#.###.#############.#
#.#.#...#.....#.#.....#
#.#.###.#.#.###.#.###.#
#.........#.....#.#...#
#######################
