#######################
#...#...#.#...........#
#.###.###.#####.#####.#
#...#.#...#.......#.#.#
#.###.###.#.###.###.###
#.....#....E#...#.#...#
###.###.#.#.###.#.#.###
#...#.#.#.#.#.#...#...#
###.#.###.###.#.#####.#
#S....#.#...#.#...#...#
###.###.###.#.#.###.#.#
#.......#...#.#.#...#.#
#######.#####.#.#.#.#.#
#...#...#.....#...#.#.#
###.###.#.###.#######.#
#...........#.#.....#.#
###.#.#.#####.###.#.#.#
#...#.#...#.......#...#
###.#.###.###.#.#####.#
#...#.#.#.#...#...#...#
#.#####.###.###.#.#####
#.....#.#.....#.#.#...#
#.###.#.#.###.#.###.#.#
#...#.#.....#.#.....#.#
#######################
