#######################
#.#.............#.....#
#.###.#.###.#.###.#####
#.....#.#...#.#.#.#...#
#####.#.#.#.###.#.###.#
#.....#.#.#.....#.....#
#######.###.#########.#
#.....#...#.#.....#.#.#
#####.###.#.#####.#.#.#
#.........#.#...#.#.#.#
#.#.#.#.#.#####.#.#.#.#
#.#.#.#.#.#.#.#.......#
#.#####.###.#.###.#.#.#
#.#...#...#.......#.#.#
#.#.#.###.#.#.#.#.#.#.#
#.#.#...#.#.#.#.#E#.#.#
#.#.#.###.#######.#.#.#
#.#.#.......#.....#.#.#
###.#.#####.#####.###.#
#.#.#.#...#.......#...#
#.###.###.###.#######.#
#.....#.............#.#
#######.#.###.#######.#
#.......#...#...#.#...#
#.#####.#######.#.#####
#..S#.......#.........#
#######################
