#######################
#.#...........#.#.....#
#.#.#####.#.#.#.#.###.#
#...#.....#.#.....#...#
###.#######.#.#########
#.#.....#...#...#.....#
#.#.#######.###.#.#####
#.......#.....#...#...#
###.#######.#.#.###.###
#E#.#.#...#.#.#...#...#
#.###.#.###.#.#.#.#.#.#
#...........#.#.#...#.#
#.#############.#.#.###
#.....#...#...#.#.#...#
#.#####.#.#.#.###.###.#
#.#.....#...#...#.#.#.#
###.###.#########.#.#.#
#.....#.#.#.....#.#.#.#
#.#####.#.#.#######.#.#
#.#...#.............#.#
#.###.#######.###.#.#.#
#...#.......#.#...#...#
#.#.#.#######.#########
#.#.#.#...#.#.......#.#
###.#.#.###.###.###.#.#
#.........#.#...#S#.#.#
#.###.#.###.#.###.#.#.#
#...#.#...#.....#.....#
#######################
