#######################
#.....................#
#######.#.#########.#.#
#S................#.#.#
#########.#.#.#.#.#.###
#.......#.#...#.#.#...#
#.#######.###.#######.#
#.......#...#.......#.#
#.#.#.#####.#.#.#.###.#
#.#.#.....#.#.#.#...#.#
#####.#.###.#.#.#.#.#.#
#...#.#...#..E#.#.#.#.#
#.###.#####.#.#.#######
#...#.....#.#.#.......#
###.###.#######.#.#####
#.#...#.......#.#.....#
#####.#.###.#.#.#####.#
#...#.#...#.#.#.....#.#
#.#.#.#.###.#.#####.###
#.#.#.#...#.#.....#...#
###.###.#.#.#.#.#.###.#
#.#...#.#.#.#.#.#...#.#
#######################
