#######################
#.....#........E#.....#
#.#.###.#######.###.###
#.#.#.#.......#.....#.#
###.#.###.#####.#####.#
#...#.#.#.#...#.......#
#.###.#.#.###.#####.###
#.#...#...#.....#.....#
#.###.#####.#####.#.###
#.........#.....#.#.#.#
#.#.###########.###.#.#
#.#.#.....#.....#.....#
###.#.#.#.#.#.#######.#
#.....#.#...#.#.#S#...#
#.###.###.#####.#.#.#.#
#...#.#.#.#.#.#.#...#.#
#.#.#.#.###.#.#.###.###
#.#.#.....#...........#
#####.###.#.#.###.#.###
#.....#.....#...#.#...#
#######################
