#######################
#.......#.........#...#
#.#.#.#.###.#####.###.#
#.#.#.#.......#.#.....#
#######.#.###.#.#.#.#.#
#..E#.#.#.#...#.#.#.#.#
#.###.#####.#.#.#######
#...#.......#.#.....#.#
#.#.#.#.###.#.#.#.#.#.#
#.#...#.#.#.#...#.#...#
#.###.#.#.#####.#####.#
#.#...#.....#.......#.#
###.#####.#####.#.#.#.#
#.......#...#...#.#.#.#
#.#.###.###########.###
#.#...#...#...#.#.....#
#####.#######.#.#.###.#
#.....#...#.....#.#S..#
#.#.###.#.#.#.#.#.#####
#.#...#.#.#.#.#.#.....#
#.#####.###.#######.#.#
#.......#...........#.#
#######################
