#######################
#...#...#.....#.......#
#.#.#.###.#.###.#####.#
#.#...#...#.....#...#.#
#.#####.#########.#.#.#
#.......#...#.....#.#.#
#.#######.#.###.###.#.#
#.....#...#...#.#...#.#
#####.#.#.###.###.#.#.#
#.#...#.#.#.#.#...#.#.#
#.#.###.#.#.#.#.#####.#
#...#...#.#.#.#.#...#.#
#.#######.#.#.#.#.#.#.#
#...#.....#.....#.#...#
###.#.#######.###.###.#
#.#E..#.....#.#...#...#
#.###.#.###.#.#.###.###
#.#...#...#.#.#.#.....#
#.#.#####.#.#.#.#######
#...#.#...#.#.#...#S..#
#.###.#.###.#####.###.#
#.#...#.#.........#...#
#.#.#.#.###########.###
#.#.#.#.....#.......#.#
#.#.#.#####.#.#######.#
#...#.....#...........#
#######################
