#######################
#.....................#
#.#######.###.#####.#.#
#.......#...#.....#.#.#
###.#.###.###.###.#####
#.#.#...#...#...#.....#
###.#.###.###.###.#####
#.#.#...#...#...#.....#
#.###.#.###.#####.#####
#..S......#.....#.....#
###.#.#.#####.#.#.#####
#.#.#.#.....#.#.#.....#
#######.#.#.#.#.#######
#.....#.#.#.#.#.......#
#.#.#.#.#.#########.#.#
#.#.#.#.#.........#.#.#
#####.#.#.#.###.#.###.#
#...#.#.#.#...#.#...#.#
###.#.#.#.#.#.#.#####.#
#.#.#...#.#.#.#.....#.#
#####.#.#####.###.#.###
#...#.#E....#...#.#...#
###.#####.#.###.#.###.#
#.#.....#.#...#.#...#.#
#.#.#####.#.#.#.#.#.#.#
#.#.....#.#.#.#.#.#.#.#
#######################
