#######################
#.#.#.........#...#E#.#
#.#.#####.#.###.#.#.#.#
#.....#...#.....#.#...#
#.#.#.###.#########.###
#S#.#.#.....#.........#
###.#####.#####.#.#.#.#
#.....#.......#.#.#.#.#
#.#.###.###.#####.#.#.#
#.#.#.....#.#.....#.#.#
#.#####.#####.#######.#
#.#.........#.......#.#
#.#.###########.###.###
#...#.........#.#.#...#
###.###.#####.###.###.#
#.....#.....#.........#
#.###.###.#.#.#######.#
#.#.#.....#.#.#...#...#
#.#.#####.#######.#####
#.#.......#.#.#...#...#
#.###.#####.#.###.#.###
#.#.......#...#...#.#.#
#.###.#######.###.#.#.#
#.#.#.#.......#...#...#
###.#.#.###.#.#.#.#.###
#.......#...#.#.#.....#
###.#.###.#.#.#.###.###
#...#...#.#.#...#.....#
#######################
