#######################
#.....................#
###.###.###.#.#.#####.#
#.#...#...#.#.#.....#.#
#######.#.#.###.#.###.#
#.....#E#.#...#.#...#.#
###.###.#######.#.#.#.#
#.#...#.......#.#.#.#.#
#######.#.#####.###.#.#
#.....#.#.....#...#.#.#
#########.###.#####.#.#
#.......#...#.....#S#.#
###.###.#.#####.#.#.###
#.#...#.#.....#.#.#...#
#######.###.###.#.#####
#.....#...#...#.#.....#
###########.#.#.###.###
#.........#.#.#...#...#
###.###.###.#.#.#####.#
#.#...#...#.#.#.....#.#
#####.#.###.#.#.#####.#
#...#.#...#.#.#.....#.#
#.#.#####.#.#.#.#.#.#.#
#.#.....#.#.#.#.#.#.#.#
#.###.#.#####.###.#####
#...#.#.....#...#.....#
#######.#####.#########
#.....#.....#.........#
#######################
