#######################
#.....................#
#############.###.#####
#...........#...#.....#
###.#####.###########.#
#.#.....#...........#.#
###.#.###########.#####
#.#.#...........#.....#
#.###.#####.#.###.###.#
#...#.....#.#...#...#.#
#####.#######.###.#.###
#...#.......#...#.#...#
###.#.#.#.#####.#######
#............E#.......#
#.#.#.#.###.#.#.#######
#.#.#.#...#.#.#.......#
#.#.#.#.#.#.#.#######.#
#.#.#.#.#.#.#.......#.#
#.###.#####.#########.#
#S..#.....#.........#.#
#######################
