#######################
#...............#.....#
#.#.#.#####.###.#####.#
#E#.#.#.#...#...#...#.#
#.#####.###########.#.#
#.....#.......#.....#.#
###.#####.###.#.#.#.#.#
#.#.#.#.#...#...#.#.#.#
#.#.#.#.#.#########.#.#
#.#.#...#...#...#.....#
#.#.#.###.###.###.###.#
#...............#...#.#
#.#######.###.###.#####
#.......#.#.#.#.......#
#.#########.#.#.#.###.#
#...#.#.....#.#.#.#...#
###.#.#####.###.#.#.###
#...#...#...#...#.#.#S#
#.#.###.#.#.###.#.#.#.#
#.#.#.....#...#.#.#...#
#####.#.###.###.#######
#.....#.#.............#
#######################
