#######################
#.......#.............#
#######.#.###########.#
#.......#...#...#...#.#
#.#####.###.#.###.#.#.#
#.....#...#...#...#...#
#.###.###.###.#.#####.#
#.#.#...#.#...#.#.....#
#.#.###.###.###.###.###
#.#...#.......#...#...#
#.###.#######.###.###.#
#....E#.....#.#...#...#
#.#####.###.#.#.###.###
#.#.....#...#.#.#...#.#
#.#.#####.#####.###.#.#
#.#.#...#.....#...#...#
###.#.#.#####.#.#.###.#
#...#.#.......#.#.#...#
#.###.#########.#.#####
#.#...#.....#...#.....#
#.###.###.###.#######.#
#...#...#...#.#.......#
#.#.###.###.#.#.#####.#
#.#...#...#...#.#...#.#
#.###.###.#####.#.###.#
#...#...#.#.....#...#.#
###.###.#.#.#####.#.#.#
#.....#S#...#.....#...#
#######################
