#######################
#.........#...........#
#.#######.#.#.#######.#
#.#.#.....#E#...#...#.#
#.#.#.#####.###.#.#.#.#
#.#.......#.#...#.#...#
#.#######.###.#####.###
#.......#...#.....#...#
#.#####.###.#.###.###.#
#.....#...#.#.#...#...#
#####.###.#.###.#.#####
#...#...#.#.....#.#...#
###.###.#.#########.#.#
#...#...#...........#.#
#.###.###############.#
#.#...#.............#.#
#.#.#############.#.#.#
#.#.#.............#.#.#
#.#.#.#####.#####.###.#
#...#...#...#...#.#...#
#.#####.#####.#.#.#.#.#
#.......#.....#.#.#.#.#
#######.#.#####.###.#.#
#...#...#.....#.....#.#
#.###.#######.#######.#
#.....#.....#...#...#.#
#.#######.#.###.#.###.#
#.........#.#S..#.....#
#######################
