#######################
#.#.........#.........#
#.###.#.#.#.#.###.#####
#.....#.#.#...#.......#
#.###############.###.#
#...#...#.......#.#.#S#
#####.###.#######.#.###
#.....#...#.....#.#...#
###.#####.#.###.#.#.###
#.#.....#.....#.#.....#
#.###.###.#.#####.###.#
#...#.#...#.#.....#...#
#.###.#####.###.#.#####
#.......#.#...#.#.#...#
#.###.#.#.#.###.#.###.#
#...#.#...#.....#.....#
#.###.#.#.#####.###.###
#.#...#.#.#...#.#.#.#.#
#.#.#######.#.#.#.###.#
#.#.#.....#.#.........#
#.###.###.###.#####.#.#
#.#.#.#.......#...#.#.#
#.#.###.###.#####.###.#
#.......#....E..#...#.#
#.#.#######.###.#.#####
#.#.#.....#.#...#...#.#
#.#.#.###.#.#####.#.#.#
#.#.#.#...........#...#
#######################
