#######################
#.......#.......#.#...#
#.#####.#.#####.#.#.#.#
#...#...#...#.#.#.#.#E#
###.#.###.#.#.#.#.#.#.#
#...#...#.#.#.#.#...#.#
#.#####.#.#.#.#.#####.#
#.#...#.#.#.#.#...#...#
#.#.#.#.#.#.#.###.#.###
#.#.#...#.#.#.#...#...#
#.#.#######.#.#.###.#.#
#.#...#...#.#.....#.#.#
#.###.#.#.#.#####.###.#
#...#...#.#...#...#...#
#.#.#####.###.#.###.#.#
#.#.#...#.#...#.#...#.#
#.#.###.#.#.###.#.#####
#.#.#...#...#.#.#.....#
###.#.#######.#.#.###.#
#...#...........#...#.#
#.###.#############.#.#
#...#...........#...#.#
#.#.###########.#.###.#
#.#...#.....#...#...#.#
#.###.#.#.###.###.###.#
#.#...#.#.#...#...#...#
#.#.###.#.#.#######.#.#
#.#S#...#...........#.#
#######################
