#######################
#.....#.#...#.......#.#
###.#.#.#.#.#####.#.#.#
#...#...#S#...#...#.#.#
#.#####.#####.#.###.#.#
#...#.....#...#...#...#
###.#######.#####.###.#
#...#.......#.....#...#
#.#.#.#######.#####.###
#.#.#.#.......#...#.#.#
#.###.#.#######.###.#.#
#...#...#.....#...#.#.#
###.#####.###.###.#.#.#
#...#...#...#.....#...#
#.#.#.###.#.#########.#
#.#...#...#...........#
#.###.#.###############
#.#...#.#...#.........#
#.#.###.#.#.#.###.###.#
#.#...#.#.#.#.#...#...#
#.#####.#.#.#.#.###.###
#.....#.#.#...#.#...#.#
#.###.#.#######.#.###.#
#E..#...........#.....#
#######################
