#######################
#.....#...#.......#...#
###.#.###.#.#.#.###.#.#
#...#.#E#.#.#.#.#...#.#
###.###.#.#####.###.###
#.....#.#...........#.#
###.#.#.###.#####.###.#
#...#...#...#.........#
###.#.#######.#######.#
#...#.....#.......#...#
#.#.#####.#.#.#.#######
#.#.#...#...#.#.......#
#.#.#.###.###.#######.#
#.#.#.#...#...#...#...#
###.#.#.#########.###.#
#...#.....#...#.#.....#
###.#.###.#.#.#.#.###.#
#...#.#.#.#.#...#.#...#
#####.#.#####.#####.#.#
#S..#...........#...#.#
###.###.#.#.#########.#
#.#.#.#.#.#.#...#.#.#.#
#.#.#.###.#.#.#.#.#.###
#.........#...#.......#
#######################
