#######################
#.....................#
#.#######.#.#.###.#####
#.......#.#.#...#.....#
#.#########.#.#####.#.#
#....E....#.#.....#.#.#
#######.#####.#.#.#####
#...........#.#.#.....#
#####.#.#.#.#.###.#####
#...#...#.#.#...#.....#
###.###.#.###.###.#####
#.#...#.#...#...#.....#
#.###.#.###.#.#.#.#####
#...#.....#.#.#.#.....#
#.#.###.#.#.#######.###
#.#...#.#.#.......#...#
#.#####.#.###.###.#####
#.....#S#...#...#.....#
###.#.###.#.###.#.###.#
#.#.#...#.#...#.#...#.#
###.#######.#####.#.###
#.#.......#.....#.#...#
#.#.#.#############.#.#
#.#.#.............#.#.#
#######################
