#######################
#.#.................#.#
#.#######.#######.#.#.#
#.......#.....#...#.#.#
#.#.#####.###.###.###.#
#.#...#.....#...#.....#
#.#####.#.#.#.#########
#..E#...#.#.#.#.......#
#.###.#############.#.#
#...#.....#...#.....#.#
###.###.#####.#.###.###
#.#.....#.........#...#
#.#.#######.#####.#####
#.....#.#.#.#.#...#...#
#.#####.#.###.###.#.###
#.....#.....#...#.....#
#.#####.#.#.###.#.#.#.#
#...#...#.#.#.#.#.#.#.#
#.#######.###.#.#.#.###
#.#.#.......#.....#.#S#
#.#.#####.#.#.#.###.#.#
#.#.#.....#...#...#...#
#.#.#.#######.#####.###
#...#...#.....#.....#.#
###.#.#.###.#######.#.#
#.....#...#.......#...#
#######################
