#######################
#.......#.............#
#.###.#.###.#.#######.#
#.#...#...#.#.......#.#
#.#.#####.#.#######.#.#
#.#.#...#.#...#.#...#.#
###.#.###.###.#.#.###.#
#...#.....#...#.#...#.#
#.###.#####.###.###.###
#.#...#.#....E....#...#
#.#.###.#.#########.#.#
#S#.#.#...#.......#.#.#
###.#.#.###.#####.###.#
#...#...#.#.....#...#.#
#.###.###.#####.###.#.#
#.#...........#.#.....#
#.#####.#####.#.#####.#
#...#...#...#.#...#.#.#
###.#####.#.#####.#.#.#
#.#.#.....#.......#.#.#
#.#.#.#############.#.#
#...#.#...#.....#.....#
#.###.#.#.#.###.#.#####
#...#.#.#.#...#...#...#
###.#.#.#.###.#####.#.#
#.....#.#...........#.#
#######################
