#######################
#.......#...........#.#
#.#######.#######.#.#.#
#...#.....#...#...#...#
#.#.#.#####.#.#.#.#####
#.#...#...#.#.#.#.#...#
#.#####.#.#.#.#.###.#.#
#.....#.#...#.#.....#.#
#####.#.#####.#######.#
#...#.#...#.#.#.....#.#
#.###.###.#.#.#.#####.#
#...#.#...#.#.#...#..E#
###.#.#.###.#.###.#.#.#
#...#...#.#...#...#.#.#
#.#######.#.###.#.#.#.#
#...............#.#.#.#
#.#################.#.#
#.#...............#.#.#
###.#############.#.###
#...#...........#.#...#
#.###.#########.#.###.#
#.......#S......#.....#
#######################
