#######################
#.#.......#.......#...#
#.###.#######.###.###.#
#.#...#.........#.#...#
#.###.#.#.#####.#.###.#
#.#...#.#.....#.#.....#
#.#.###.###.#.###.###.#
#.....#..E#.#.#.....#.#
#.#######.#.#######.#.#
#.......#.#.....#...#.#
#####.###.###########.#
#...#.....#...........#
###.#.###.#.#.#.#####.#
#.......#.#.#.#...#...#
#######.#.#####.###.###
#.#.....#.#...#.#.....#
#.#.#######.###.#####.#
#...........#...#.#S..#
#############.#.#.###.#
#.............#.....#.#
#######################
