#######################
#.#.......#...........#
#.#.#####.#.#####.###.#
#.#...#...#.#...#.#...#
#.###.#.###.#.#.#.#.###
#...#.#...#.#.#...#...#
#.#.#.###.#.#.#######.#
#.#.#S#.#.#.#.#.#...#.#
#.#.###.#.###.#.#.#.#.#
#.#.....#.....#...#...#
#.#####.#######.#######
#.#...........#...#...#
###.#############.#.#.#
#...#.....#.......#.#.#
#.#.#.###.#.#######.#.#
#.#.#...#.#.....#...#.#
#.###.###.#####.#.###.#
#E....#.....#...#...#.#
#.#####.###.#.#####.###
#.#...#...#.#.....#...#
#.#.#.###.#######.###.#
#...#...#.............#
#######################
