#######################
#.....................#
#.#.#####.###.#.#.###.#
#.#.....#...#.#.#...#.#
###.###.#.#.###.#.#.#.#
#.#...#.#.#...#.#.#.#.#
#.#####.#.#.#####.#.#.#
#.....#.#.#.....#.#.#.#
#.###.###.#.#.#.#######
#...#...#.#.#.#.......#
#####.#######.#.#####.#
#...#.......#.#.....#.#
#.#.#######.#.#.#.###.#
#.#.......#.#.#.#...#.#
#.###.#######.#.#.###.#
#...#.......#.#.#...#.#
###########.#.#.#####.#
#..........S#.#.....#.#
#####.#######.#########
#...#.......#.........#
#.###.#####.#.#.#######
#.........#.#.#.......#
#.#.#.#.#####.#####.#.#
#.#.#.#.....#.....#.#.#
###.#.#######.#.###.###
#.#.#.......#.#...#...#
#.#.#.#######.###.###.#
#.#.#E......#...#...#.#
#######################
