#######################
#.....................#
###.#.###.###.#.###.###
#.#.#...#...#.#...#...#
#.###.#.#.#.#.#.#######
#...#.#.#.#.#.#.......#
#.#.###.###.#.#.#####.#
#.#...#...#.#.#.....#.#
#.#.###.#.###.#.#.###.#
#.#...#.#...#.#.#...#.#
#####.#.#######.#.#####
#...#.#.......#.#.....#
#.#.###.#.###.#.#.###.#
#.#...#.#...#.#.#...#.#
#######.#.#########.###
#E................#...#
#.#########.#.#.#.#.#.#
#.........#.#..S#.#.#.#
###.#####.###.###.#.###
#.#.....#...#...#.#...#
#.#####.#.#######.#.###
#.....#.#.......#.#...#
###.#########.#.#.#####
#.#.........#.#.#.....#
#####.###.#####.#######
#...#...#.....#.......#
#######.###.#####.#.#.#
#.....#...#.....#.#.#.#
#####.###.#.#.#.###.#.#
#...#...#.#.#.#...#.#.#
#######################
