#######################
#.....................#
#.###.#######.#.#######
#...#.......#.#.......#
#.#.#.###.#######.#.###
#.#.#...#.......#.#...#
#########.#.###.#####.#
#.......#.#...#.....#.#
#######.#.#######.###.#
#.....#.#.......#...#.#
#.###.#.#.#.###.#.#.#.#
#...#.#.#.#...#.#.#.#.#
###.#####.###.#.#######
#.#................E..#
#.#.###.###.#######.#.#
#.....#...#.......#.#.#
###.#.#.#.#.#.#.###.#.#
#.#.#.#.#.#.#.#...#.#.#
###.#.###.###.###.#.#.#
#...#...#...#...#.#.#.#
###.###.#.#.#.#.###.###
#.#...#.#.#.#.#...#...#
#.#.#.#####.#########.#
#...#.....#.........#.#
#.#.#######.###.#######
#..S......#...#.......#
###.#.#.###.#####.#.#.#
#.#.#.#...#.....#.#.#.#
#####.#########.#.#.#.#
#...#.........#.#.#.#.#
#######################
