#######################
#..E....#.#.#.#...#...#
###.#.###.#.#.#.###.###
#...#...#.........#...#
#####.#.#######.###.###
#.#...#...#.#...#...#.#
#.#######.#.#.#.#.#.#.#
#.....#...#...#...#...#
#.###.#.#.#########.###
#...#...#.#.#...#.....#
#####.###.#.#.###.#.###
#.....#...#.......#...#
###.#########.###.#####
#.....#...#.....#...#.#
#.#.###.#.#.#########.#
#.#.....#.........#...#
#####.#.#.#####.#.###.#
#...#.#.#.....#.#.....#
###.#.###.#########.#.#
#...#.#.........#.#.#S#
#.#####.#.###.###.#####
#.....#.#.#.#.#.......#
#.#.###.#.#.###.#######
#.#.....#.......#.#...#
#.#####.###.#####.###.#
#...#...#...#.#.#...#.#
###.#.###.#.#.#.#.###.#
#...#...#.#.#...#.#.#.#
#####.#####.#.###.#.#.#
#.......#.............#
#######################
