#######################
#.#.#.....#.#.#.......#
#.#.#.###.#.#.###.#.###
#.....#.#...#...#.#.#.#
#######.#.###.###.###.#
#S..#.....#...#...#...#
###.###.#####.#.###.###
#.#...#.....#.#.....#.#
#.#.#####.#.#.###.###.#
#.....#...#.........#.#
#.###.###.#####.###.#.#
#.#...#...#.......#...#
#.#####.#####.###.#.#.#
#.........#.#.#.#.#.#.#
#.#########.###.#####.#
#...#.....#.#.....#...#
###.###.#.#.#.#######.#
#.#.....#.#...#.#.....#
#.###.#######.#.#####.#
#...#.......#.....#...#
#.#.###.#####.###.#.###
#.#.#.....#...#.#.#...#
#.#########.###.#.#.#.#
#E#.#.........#.#.#.#.#
#.#.#.###.###.#.#.###.#
#...#.#.#...#...#.....#
#.###.#.#######.#####.#
#.#.......#...#.#.....#
#.#.#.#####.###.###.###
#...#.#...........#...#
#######################
