#######################
#.....................#
#####.###########.###.#
#....................E#
###.#.#.#.#######.#.#.#
#...#.#.#.......#.#.#.#
#.#.###.#.###.#.#.###.#
#.....#.#...#.#.#...#.#
###.#.###.#.#.#.#.#.###
#.#.#...#.#.#.#.#.#...#
###.#.#.#.###.###.###.#
#.#.#.#.#...#...#...#.#
#.#.###########.#.#.###
#.............#.#.#...#
#.#.#.#.#.#########.#.#
#.#.#.#.#.........#.#.#
#.#.#.#.#######.#.#.#.#
#...#.#.......#.#.#.#.#
#.#.#.#.#.#.#.#####.#.#
#.#.#.#.#.#.#.....#.#.#
###.#.###.#.#.#.#.###.#
#.#.#...#.#.#.#.#...#.#
#.#.#.#####.#######.#.#
#.#.#.....#.......#.#.#
#.#.###.#.#######.###.#
#.....#.#.......#...#.#
###.###.#######.#######
#.#...#.......#.......#
###.###########.#.#####
#.#S..........#.#.....#
#######################
