#######################
#...........#...#.....#
#########.#.#.###.###.#
#.....#...#...#...#.#.#
#.#####.#####.#.###.###
#.......#...#.......#.#
#.###.#.###.#.#######.#
#.#...#...#.#.....#...#
#.###.###.#.#####.###.#
#.#.#.#.#...#.#.....#.#
###.#.#.#.###.###.###.#
#......E#.#.......#.#.#
#####.#######.###.#.#.#
#...#.....#.....#.#...#
###.#.#####.###.#.#.#.#
#.#...#.....#.#.#.#.#.#
#.###.#.#####.#####.#.#
#.#.#.#.....#.......#.#
#.#.#.###.###.#########
#.....#.#...#.........#
#.#.#.#.#.#####.###.#.#
#.#.#...#.....#...#.#.#
#.#.#########.#.#.#####
#.#...#.#.....#.#.....#
###.#.#.#####.#.#####.#
#...#.......#.#.#.....#
#.###.#.#####.###.#.#.#
#...#.#...#.#.....#.#.#
#####.#.###.#.###.#####
#.....#...#...#......S#
#######################
