#######################
#...#.................#
#.#.#.###############.#
#.#.#...#.....#.....#.#
#.#.###.###.#.#.#####.#
#.#..S#.#...#...#.....#
#.#####.#.#####.#.#####
#.......#.....#.#.#...#
#########.###.###.#.#.#
#...#.....#...#...#.#.#
###.#.#####.#.#.###.#.#
#...#.#...#.#.#.#...#.#
#.###.#.#.#.#.#.#####.#
#.#...#.#...#.#.....#.#
#.#.###.#####.#####.#.#
#.#...#...#.......#...#
#.###.###.###########.#
#...#...#.............#
###.###.###############
#.....#.#E#.........#.#
#.#####.#.#.#.#####.#.#
#...#...#...#.....#.#.#
#.#.#.#######.###.#.#.#
#.#.#.#.....#.#...#...#
#.#.#.#.###.###.#####.#
#.#...#...#.....#.....#
#.#####.#.#######.#####
#.#.....#...#...#.#...#
#.#########.#.#.#.#.#.#
#...........#.#.....#.#
#######################
