#######################
#...........#.....#...#
#.#.###.###.#.###.###.#
#.#.#.#.#S#...#.......#
#.#.#.#.#.#.###########
#.#.#...#.#.#.........#
###.#.###.###.#######.#
#...#...#.....#...#...#
#.#####.#######.#.#.###
#...#...#...#...#.#...#
#.#.#####.#.#.###.###.#
#.#.#.....#...#...#...#
#.#.#.#########.#.#.###
#.#...#.......#.#.#...#
#.#####.#####.#.#####.#
#.....#.....#.#.#.....#
#####.#######.#.#.#####
#...#.........#...#...#
#.###########.#######.#
#.....#.....#.#.......#
###.#.###.#.#.#.#######
#...#...#.#.#.#.......#
#.#####.###.#.#.#####.#
#.#.....#...#.#...#.#.#
#.#####.#.#.#.###.#.#.#
#.....#...#.#.#.....#.#
#.###.#######.#####.#.#
#.#.#..E....#.#...#.#.#
#.#.#######.#.#.#.###.#
#.........#.....#.....#
#######################
