#######################
#.......#...........#.#
#.#####.#.###.#####.#.#
#.#.....#...#...#E..#.#
#.#########.###.#.###.#
#.#.........#.#.#.#...#
#.#.#########.#.#.###.#
#...#.......#.#.#.....#
#.###.###.#.#.#.#######
#.#.....#.#...#.......#
#.#####.#.###.#######.#
#.#...#.#...#.......#.#
#.#.#.#####.#########.#
#...#.....#.....#.....#
#########.#####.#.###.#
#.....#...#.....#.#.#.#
#.#.###.###.###.#.#.#.#
#.#.........#...#.#...#
#.###########.###.#####
#.#...#.....#...#.....#
#.#.#.#.###.#########.#
#.#.#.#.#.#.....#.....#
#.#.###.#.#####.#.###.#
#.#.#...#.......#...#.#
#.#.#.###.#####.###.#.#
#...#.#.....#S#.....#.#
#.###.#######.#######.#
#.#...#...#...#.......#
#.#.###.#.#.###.#######
#.#.....#...#.........#
#######################
