#########################
#.......................#
#.#.#.###.#.#.#.###.#.###
#.#.#...#.#.#.#...#.#...#
###.###.#.#####.#.#.#####
#.#...#.#.....#.#.#.....#
#.#.#####.#####.#.#####.#
#.#.....#..S..#.#.....#E#
#######.###.###.#.#.###.#
#.....#...#...#.#.#...#.#
#########################
