#########################
#.......................#
#.#.#####.#.#.#.#######.#
#.#.....#.#.#.#.......#.#
#####.###.#.#.#.#.#.###.#
#...#...#.#.#.#.#.#...#.#
#.#####.#####.#.###.###.#
#.....#E....#.#...#..S#.#
#.#####.#.#.###.#.#######
#.....#.#.#...#.#.......#
#####.#####.#.#####.#.#.#
#...#.....#.#.....#.#.#.#
#.#.###########.#.#.#####
#.#...........#.#.#.....#
#########################
