#########################
#.......................#
#.#.#.#.###.###.#######.#
#.#.#.#...#...#....E..#.#
###.###.#############.#.#
#.#...#.............#.#.#
###.#.#####.#.#.#####.#.#
#.#.#.....#.#.#.....#.#.#
#######.#######.#.###.#.#
#.....#..S....#.#...#.#.#
#.#.#.#.###.###.###.#####
#.#.#.#...#...#...#.....#
#########################
