#########################
#...#...#.............#.#
#.###.###.#####.###.###.#
#.......#E#...#...#.#...#
#####.#.#.###.###.#####.#
#...#.#.......#.#...#.#.#
#.###.###.#####.###.#.#.#
#.#.....#...#.#.....#.#.#
#.#########.#.#####.#.#.#
#.#.....#.#...#.#.#.....#
#.###.###.#.#.#.#.#.###.#
#.#.#.......#.#.#.#.#...#
#.#.#.#.###.###.#.#.#.###
#.#.#.#...#.......#.#...#
#.#.#.#.###.###.###.###.#
#.....#.#.....#.#.....#S#
#########################
