#########################
#.......#............E..#
#####.###.#####.#######.#
#.....#...#...#...#.....#
#.###.#.###.#.###.###.###
#.#.#.#.#...#...#...#...#
#.#.#.#.#######.###.###.#
#.#...#.#...#.....#.#...#
#.#####.#.#.#.###.#.#.###
#.........#...#...#S#...#
#########################
