#########################
#.........#...#.#.......#
#######.###.#.#.#.###.#.#
#.....#...#S#.#.#...#.#.#
#.###.###.###.#.###.#.#.#
#...#...#...#.#.....#.#.#
#.#.###.###.#.#.#####.###
#.#...#...#.#.#.#...#...#
#.###.###.#.#.###.#.###.#
#.#...#.....#.#...#.....#
###.#########.#.#########
#...#.....#...#.........#
#.#.#.###.#.###########.#
#.#.#.#.#.#.......#.....#
#.#.#.#.#.#######.#.###.#
#.#.#.#.#...#.....#.#.#.#
#.###.#.#.###.#####.#.#.#
#......E#...........#...#
#########################
