#########################
#.............#.........#
#.#####.#####.###.#####.#
#.#S..#.#...#...#.#.....#
#.###.###.#.###.#.#.###.#
#...#.#...#.#.#.#.#.#...#
#.###.#.###.#.#.###.###.#
#...#.#...#.#.#...#...#.#
###.#.###.#.#.###.#.#.###
#...#.....#.#.#...#.#...#
#.#########.#.#.#######.#
#...........#..........E#
#########################
