#########################
#...........#.......#.#.#
#.###.#####.#####.#.#.#.#
#E..#...#...#.....#...#.#
#.#######.###.#####.###.#
#...#.#...#.#.#...#...#.#
#.#.#.#.###.#.###.#####.#
#.#.#.....#.........#...#
#####.###.###.###.###.###
#.....#.#...#...#.#.#.#.#
#.#.###.#.###.#####.#.#.#
#.#...#...#.#.#.....#...#
#.#####.#.#.#.###.###.#.#
#.#...#.#...........#.#.#
#.###.#.#.#######.#.#.###
#.#...#.#...#.....#.#...#
###.#.#####.#.#####.#.#.#
#S..#.......#.#.......#.#
#########################
