#########################
#.....#..S#.........#...#
#.###.#.#######.###.#.#.#
#.#...#.#.....#.#...#.#.#
#.#.#.#.#.###.#.###.#.###
#.#E#.#...#...#...#.#...#
#.#.#######.###.#.#.###.#
#.#.#.......#...#.#.#...#
#.#.#.###########.#.#.#.#
#.#...............#...#.#
#########################
