#########################
#S....#.#......E#.......#
#####.#.#.#####.#.#.###.#
#...#...#.#.......#.#...#
###.#.###.###.#####.###.#
#.#.....#.#...#.#.#.#.#.#
#.#.###.#####.#.#.#.#.#.#
#.#...#.....#.#.#...#...#
#.###.###.#.###.#.#####.#
#.......#.#...#.....#.#.#
#.#.###.###.#.#.#.###.#.#
#.#...#...#.#...#...#...#
#########################
