#########################
#.......................#
###.###################.#
#.#...................#.#
###.#.###.###.#.###.#.###
#.#.#...#...#.#...#.#...#
###.#####.#.###.###.###.#
#.#.....#.#...#...#...#.#
###.###.#####.###.#.#.#.#
#.#...#.....#...#.#.#.#.#
#.###.###.#######.#.###.#
#...#...#.......#S#...#.#
#######.#######.#####.###
#.....#E......#.....#...#
#.#.#.#######.#####.#####
#.#.#.......#.....#.....#
#########################
