#########################
#S..#...#.#.#..E#...#...#
###.###.#.#.#.#####.#.#.#
#.#.......#.....#.....#.#
#.###.#######.#.#.###.#.#
#.#...#...#...#.#.#.#.#.#
#.#.#.#.#.#.###.#.#.###.#
#...#...#.....#.#.....#.#
#.#.#.#.#######.#.#####.#
#.#.#.#.....#.......#...#
#########################
