#########################
#.......#.#...........#.#
#.#.###.#.#.#####.###.#.#
#.#.#.....#.#...#.#...#.#
###.#####.#.###.#.#.###.#
#...#...#.#.#...#.#.#...#
#.###.#.###.#.###.#.###.#
#.....#.......#...#.....#
#.#############.#######.#
#.....#.....#E..#.......#
###.###.###.#.###.#######
#...#S..#.....#.........#
#########################
