#########################
#.....#.#.#S#...#.#.....#
###.###.#.#.#.#.#.#####.#
#...........#.#.#...#...#
#.#######.###.#####.#.###
#.....#...#.............#
###.###.#####.###.#####.#
#.....#.......#.#.#.#E#.#
#.#########.###.#.#.#.#.#
#...#...........#.....#.#
#########################
