#########################
#.#...#...#E............#
#.#.#.#.#.#.#####.#####.#
#...#.#.#.#.#...#.....#.#
#####.#.#.#.#.#.#####.###
#.....#.#...#.#.....#...#
#.###.#.#######.#.#####.#
#...#.#.........#.#.....#
#.#.#############.#.###.#
#.#...........#.#.#...#.#
#######.#####.#.#.###.###
#...#...#...#...#...#...#
#.#.#.#.#.#.#######.###.#
#.#...#.#.#.........#...#
#.#######.###########.#.#
#...........#S........#.#
#########################
