#########################
#.......................#
#.#####.###.#.#.#.#.#.#.#
#.....#...#.#.#.#.#.#.#.#
#.###.#.#.#.###.#.#.###.#
#...#.#.#.#...#.#.#..S#.#
###.#.#.#.#######.#.#.#.#
#.#.#.#E#.......#.#.#.#.#
#.#.###.#.#####.###.#.#.#
#.#...#.#.....#...#.#.#.#
#########################
