#########################
#.....#.....#.....#....E#
#.###.#.#.###.#########.#
#...#...#.#.....#...#...#
#.#####.#.#.#######.###.#
#.#...#.#...............#
#.#.#.###.###.#.#########
#.#.#.....#.#.#.#...#...#
#.###.###.#.###.#.#.###.#
#...#...#.#.#...#.#...#.#
###.###.###.#.#####.###.#
#...#...#...#...........#
#####.#####.#######.###.#
#................S#.#...#
#########################
