#########################
#...#.#...........#.....#
#.###.#.#####.#########.#
#.........#.#.#.#.#.#...#
#.#.###.###.#.#.#.#.###.#
#.#.#...#..E#...#.......#
#.#.#.#####.###.#####.#.#
#.#.#.....#.....#.....#.#
#####.#########.#.###.###
#.#...#...#.......#.#.#.#
#.#.#####.#####.#.#.#.#.#
#.............#S#...#...#
#########################
