#########################
#.......................#
#.###############.#####.#
#...............#.....#.#
###.#.#.#.###.###.#####.#
#.#.#.#......S..#.....#.#
#.#.#.#.#########.#.#.###
#.#.#.#.........#.#.#...#
###.###.#.#.###.#########
#.#.....#.#...#.........#
#.#####.#.#.#.#####.#.#.#
#.....#.#.#.#.....#.#.#.#
###.#.#.#.#.#.###.###.#.#
#.#.#.#.#.#.#...#...#.#.#
#######.###.#.#.#.#.#####
#......E..#.#.#.#.#.....#
#.###.###.#.#.###.#.#####
#...#...#.#.#...#.#.....#
#########################
