#########################
#.#S..#.................#
#.###.#.###############.#
#...#.#.#.......#...#...#
#.#.#.###.#####.#.#.#.#.#
#.#.#...#.#...#...#.#.#.#
#.#####.#.#.#.#####.#.#.#
#.....#.#.#.#.#...#...#.#
#####.#.#.#.#.#.#.#####.#
#.....#..E#.#.#.#...#.#.#
#.#########.#.###.#.#.#.#
#.#.......#.#.....#...#.#
#.#.#.###.#.###.#####.#.#
#.#.#...#...#...#...#.#.#
#.#.###.#.#######.#.###.#
#.#...#.#.#.....#.#.....#
#.###.#.###.###.#.#######
#.....#.......#.........#
#########################
