#########################
#.#...#.............#...#
#.#.#.#.#.#.#######.###.#
#...#...#.#.#S....#.....#
#.#######.#######.#####.#
#.#E....#.......#...#...#
#.#####.#######.###.#.###
#.....#...#.....#...#...#
#####.###.#.#####.#####.#
#.........#.......#.....#
#########################
