#########################
#..................E....#
#.#.###.#.###.#.#.#.###.#
#.#...#.#.....#.#.#...#.#
#####.#.#####.#####.#.#.#
#...#.#...........#.#.#.#
#.###.###.#.#.#.#.#.###.#
#...#...#.#...#.#.#...#.#
#############.#.#.#.#.#.#
#...........#.#.#.#.#.#.#
#.#####.#.#.#.#.###.#.###
#.....#.#.#...#...#.#...#
#.#######.###.#.###.#####
#.......#...#.#...#.....#
###.#####.###.###.###.###
#.#.....#.......#...#...#
#.#####.#.###.#.#.#.#.#.#
#.....#.#...#S#.#.#.#.#.#
#########################
