#########################
#...#.......#.......#...#
#.#.#.###.###.#####.#.#.#
#.#.#.#.#.......#...#.#.#
#.###.#.#########.###.#.#
#.....#...#.....#.#S#.#.#
#.#####.#.#.###.#.#.#.#.#
#.#.....#.#.#.#...#...#.#
#.#.#####.#.#.###.#####.#
#...#...#.#.#.#...#.#...#
#####.#.#.#.#.#.###.#.###
#.....#.#.#.#.....#.#.#.#
#.#####.#.#.#####.#.#.#.#
#...#.#.#.#.#...#...#.#.#
#.#.#.#.#.#.#.#.#.###.#.#
#.#.#...#.#...#.#.#...#.#
#.#.#####.#####.###.###.#
#.#...........#......E..#
#########################
