#########################
#.......#...#.....#.#...#
#.#.#.#.#.###.#.###.#.#.#
#.#.#E#...#...#...#...#.#
###.###.###.###.#####.#.#
#...#.......#.........#.#
#######.#######.#.###.#.#
#.......#...#...#.#.#.#.#
###.###.###.#.#####.###.#
#S#...#.....#.....#...#.#
#.#.#######.#####.#.###.#
#.....#.........#.#.....#
#########################
