#########################
#.#.#.#.#.....#...#....S#
#.#.#.#.#####.#.###.#####
#.#...........#.#...#...#
#.#######.#####.#.###.###
#.....................#.#
###.#####.#.#.###.#####.#
#...#.#.#.#.#...#.#...#.#
###.#.#.#########.#.###.#
#.....#.#.#.#...#.....#.#
###.#.#.#.#.###.#####.#.#
#.#.#...#.#...#.........#
#.#.#.#.#.#.#.###.###.###
#...#.#E#...#.....#.....#
#########################
