#########################
#..E........#...........#
#######.#####.#.#######.#
#.....#.......#.......#.#
#.###.###############.#.#
#.#.......#...#.....#.#.#
#.#######.#.#.#.###.#.#.#
#.......#.#.#...#.....#.#
#######.#.#.#############
#.....#S#.#.............#
#.###.###.#.###########.#
#.#.#.#...#...#.......#.#
#.#.#.#.#######.#####.#.#
#...#...........#.......#
#########################
