#########################
#.#.....#...#.....#.....#
#.###.#.###.#.#.###.#####
#.#...#.....#.#.........#
#.#####.#.#.#######.###.#
#.#....E#.#.#...#.....#.#
#.#.#####.#.###.###.#.###
#...#.....#.#.....#.#...#
#####.#.###.#.#####.#.###
#.#.#.#...#...#...#.#.#.#
#.#.#.###.#.#.###.#.#.#.#
#.......#.#.#...#.#.#...#
#.#.#.#######.###.###.###
#.#.#.....#.......#.....#
#.###.#####.#.#####.#.###
#..S#...#...#.......#...#
#########################
