#########################
#..........S............#
#.#####.###.#########.#.#
#.....#...#.........#.#.#
#.#.#.#####.#.#.#.#####.#
#.#.#.....#.#.#.#.....#.#
#.#.#.#####.###.#####.#.#
#.#.#.....#...#.....#.#.#
#.###############.###.###
#...............#...#...#
###.#.#.#.#.###.#####.###
#.#.#.#.#.#...#.....#...#
###.#.#.#####.#.#.#######
#.#.#.#.....#.#.#E......#
#########################
