#########################
#...#............E......#
#.###.#############.###.#
#.......#...#.....#...#.#
#.#######.#.#.###.###.#.#
#.#...#...#.#.#.#.#...#.#
#.#.#.#.###.#.#.#.#.###.#
#.#.#.#...#...#.....#.#.#
#.#.#####.###########.#.#
#.#.....#.......#.....#.#
#.#####.#######.#.#####.#
#...#.......#.#.#.......#
###.#.#####.#.#.###.#####
#.#...#.....#.#...#.....#
#.#####.#####.###.#####.#
#...............#S#.....#
#########################
