#########################
#.......................#
###########.#####.#.#.#.#
#.........#.....#.#.#.#.#
#.#.#.#.#############.#.#
#.#.#.#.............#.#.#
#.#######.#.#####.#.#####
#......................E#
#.#######.###.#.#.#.#####
#S......#...#.#.#.#.....#
#####.###.#.#######.#.#.#
#...#...#.#.......#.#.#.#
#########################
