#########################
#...#......E..#.........#
#.#.#.#.#####.#.#####.#.#
#.#.#.#...#...#.#.....#.#
#.###.###.###.###.#####.#
#...#.#.#...#.....#.....#
###.#.#.###.#######.#####
#...#...#...#.....#.....#
#.###.###.###.#.#######.#
#.....#S#...#.#.#.......#
#.#####.###.#.#.#.#######
#.#...#.#...#.#.#.#.....#
#.#.#.#.#.###.#.#.###.#.#
#...#.#...#...#.......#.#
#########################
