#########################
#.....#.......#.........#
#.#.#.#.###.#.#.#######.#
#.#.#.#.#.#.#...#.......#
#.#.###.#.#.#####.#######
#.#.....#.#.#...#.#S....#
#.#######.#.#.#.#######.#
#.#.......#.#.#.....#...#
#.#.###.###.#.###.###.###
#...#...#...#.#.#.....#.#
#####.###.###.#.#######.#
#.......#..............E#
#########################
