#########################
#...#.....#.#...#.....#E#
###.#####.#.###.###.#.#.#
#...#...........#.#.#...#
#.#.###.#.#####.#.#####.#
#.#...#.#...#.......#...#
#.###.#####.#######.#.###
#.#.#.#.....#...#.....#.#
###.#.#.#######.#.###.#.#
#.....#...#...#.....#.#.#
###.#.#######.#.###.###.#
#...#.......#.#...#.....#
#.###.###.#.#.#.#.#######
#.#.....#.#.....#.......#
#.###########.#######.#.#
#.#...#.......#...#...#.#
#.#.#.#.###.#.#.#.#.#.#.#
#.#S#.....#.#.#.#...#.#.#
#########################
