#########################
#S......................#
###.#.#.#.#.#######.#####
#.#.#.#.#.#.......#.....#
#.#.#.#.#.#####.#.#.###.#
#.#.#.#.#.....#.#.#...#.#
#.###.#.###.###.#.#.#.#.#
#...#.#...#...#.#.#.#.#.#
#.#.#####.#.###.#.#.#.###
#.#.....#.#...#.#.#.#...#
#.#######.###.###########
#.......#...#...........#
###.#.#.#.#.#########.#.#
#.#.#.#.#.#E........#.#.#
###.#.###########.#.###.#
#.#.#...........#.#...#.#
#########################
