#########################
#.......................#
#.#.###.#.#.#############
#.#...#.#.#.............#
#####.###.###.#######.###
#S......................#
###.#.###.#.#.#####.###.#
#.#.#...#.#.#.....#.....#
#####.#.###.###.###.#.#.#
#...#.#...#...#...#.#.#.#
###################.#.#.#
#.................#.#.#.#
#.#####.#.#.#.#####.#.#.#
#.....#.#.#.#.....#.#..E#
###.#####.#.#.###.###.#.#
#.#.....#.#.#...#...#.#.#
###########.#.#########.#
#.........#.#.........#.#
#########################
