#########################
#.#.....#...#...#.#.#.#E#
#.###.#.###.###.#.#.#.#.#
#.....#.......#.#.......#
#.###.###.#####.#.#.#.###
#...#..S#.#.......#.#...#
###.#.###.#.#####.###.###
#...#...#.......#.#.#...#
#####.#.#.#########.#.###
#.....#.#...#...........#
#########################
