#########################
#S#...#.........#.#.....#
#.###.#########.#.#.#####
#.............#.#.#...#.#
#####.#######.#.#.###.#.#
#.#...#...#.......#.....#
#.###.#.#.#####.###.#####
#.#.....#.#.#E#.#.#.....#
#.#.#######.#.#.#.#.###.#
#.......#.#.#...#...#...#
###.#####.#.#########.#.#
#...#.#...#...#...#...#.#
#.#.#.###.###.#.#.#.#####
#.#.#.........#.#.......#
###.#.#######.#.#####.###
#.....#.............#...#
#########################
