#########################
#...............#.......#
#######.###.###.#####.#.#
#...#.....#.#.#.#..E#.#.#
#.#.#.###.###.###.#.#.#.#
#.#...#.#...#...#.#.#.#.#
#.#####.#.#.#.#.#.#.###.#
#.....#.#.#...#...#.#.#.#
#.#.###.###.#####.###.#.#
#.#.....#.#...#.#.#.#...#
#.#.#####.#.#.#.###.#.###
#.#.....#.#.#.......#...#
#.#######.###.###.###.#.#
#.......#.....#.......#S#
#########################
