#########################
#.......................#
#.#####.#####.###.#.#.###
#.....#.....#...#.#.#...#
#####.###.#.#.#.#.#######
#E..#...#.#.#.#.#.......#
#.#.#.###############.###
#.#.#...............#...#
###.#####.#.#######.#.###
#.#.....#.#.......#.#...#
#.#####.#####.###.#######
#.....#.....#...#.......#
#.#.#.#####.#########.###
#.#.#.....#........S#...#
#########################
