#########################
#.#.....#.....#.........#
#.#.###.#.#.#.#####.#####
#...#.#...#.#...#...#...#
#.###.#####.###.#.###.#.#
#.....#...#.#.#.#.....#.#
#######.#.#.#.#.#######.#
#.....#.#.#.#.#.#...#...#
#.###.#.#.#.#.#.#.#.#.#.#
#S#.#...#...#...#.#...#.#
###.#########.###.#####.#
#............E#.....#...#
#.#################.###.#
#...#.............#...#.#
###.#######.#####.###.#.#
#...........#.........#.#
#########################
