#########################
#.#.............#.......#
#.#.###.#######.###.#.#.#
#.#.#...#...#.....#.#.#.#
#.#.#.###.#.#####.#.#.#.#
#.#.#.#...#...#...#.#.#.#
#.#.#.#.#####.#.###.#.#.#
#...#.....#...#.#...#.#.#
#########.#.###.###.#.#.#
#...#...#.#...#...#.#.#.#
#.#.#.#.#####.###.#.#.###
#.#...#.#...#...#.#.#...#
#.#####.#.#.###.#.#####.#
#S#.......#.....#......E#
#########################
