#########################
#.......................#
#.#.#.#.###.###########.#
#.#.#.#...#...........#.#
#.#######.#.###.###.#.###
#.......#.#...#...#.#...#
#####.#########.#####.###
#...#......S..#.....#...#
#.#.#.#.###.#######.#.#.#
#.#.#.#...#.......#.#.#.#
#######.###.#####.#######
#.....#...#.....#E......#
#########################
