#########################
#................E......#
#.#.#.#.#.#.#.#.###.#####
#.#.#.#.#.#.#.#...#.....#
###.###.#####.#.#########
#.#...#.....#.#.........#
#.###.###.#.###.#########
#...#...#.#...#.........#
#.#.#.###.###.#####.###.#
#.#.#...#S..#.....#...#.#
#########################
