#########################
#...#.....#.........#E..#
###.#.###.###.###.#####.#
#.....#.#.....#...#.#...#
#####.#.#####.###.#.#.###
#...........#...#.#...#.#
#.#####.#############.#.#
#.#.#.....#.......#.#...#
#.#.###.###.###.###.###.#
#.#...#...#...#.....#...#
###.#.#.###.#.###.#####.#
#...#...#.#.#...#.#.....#
#.###.#.#.#.#.#####.#.#.#
#...#.#.....#.....#.#.#.#
#.#####.#.#######.#.#.#.#
#.....#.#.#.#...#...#.#.#
#.#.###.###.#.#.###.###.#
#.#...#.......#...#...#S#
#########################
