#########################
#.......................#
#####.###.#.#.#######.###
#...#...#.#.#.......#...#
###.#.#.###.#.#.#.#####.#
#.#.#.#...#S#.#.#.....#.#
#.#####.###.###.#.#.#.#.#
#.....#...#...#.#.#.#.#E#
#.#.#.#.###.#.#.#.#.###.#
#.#.#.#...#.#.#.#.#...#.#
###.#.###.###.#####.###.#
#.#.#...#...#.....#...#.#
#.#.###.#.#.###.#####.###
#.#...#.#.#...#.....#...#
#####.###.#.###.#######.#
#...#...#.#...#.......#.#
#########################
