#########################
#.......................#
#.#.#.###.###.#.#.#.#####
#.#.#...#...#.#.#.#.....#
###.#.#.#####.#.#########
#.#.#.#.....#.#.........#
#######.#.#.#.#.#.#######
#.....#.#.#.#.#.#.......#
#.#.#.###.###.#####.#####
#.#.#..........S..#.....#
#.###.###########.#####.#
#...............#.....#.#
#####.#######.#.#.#####.#
#...#.......#.#.#.....#.#
###.#.#.#.#.#.###########
#.#..E#.#.#.#...........#
#####.#.###.#.#.#.#.###.#
#...#.#...#.#.#.#.#...#.#
#####.###.#####.#.#.#.#.#
#...#...#.....#.#.#.#.#.#
#########################
