#########################
#.......................#
###.#.#.###.#.#.#.#######
#.#.#.#...#.#.#.#.......#
#.#.#.#######.#.#####.###
#.#E#.......#.#.....#...#
###.###.#.#.#######.###.#
#.#...#.#.#.......#...#.#
###.#######.#.###.#.###.#
#.#.......#.#...#.#...#.#
###.#.###.###########.###
#.#.#...#...........#...#
#####.###.#.#.#######.###
#...#...#.#S#.......#...#
#.###.#######.#.#.###.#.#
#...#.......#.#.#...#.#.#
###.#.###.###.###.#.#.#.#
#.#.#...#...#...#.#.#.#.#
#.###.###.#.#####.#.#.#.#
#...#...#.#.....#.#.#.#.#
#.###.#.#.#########.#.#.#
#...#.#.#.........#.#.#.#
#.#.#.#.#.#.#####.#####.#
#.#.#.#.#.#.....#.....#.#
#.###.#####.#####.#######
#...#.....#.....#.......#
#.###.###.###.#.#.#######
#...#...#...#.#.#.......#
#########################
