#########################
#...#...#.......#...#...#
#.###.#.#.###.#.#.#.#.#.#
#.#...#...#.#.#...#.#.#.#
#.#.#######.#.#####.#.###
#.#.#.#.....#.#...#.#...#
#.#.#.#.###.#.#.#.#.###.#
#.#.#...#...#.#.#......E#
#.#.###.#.###.#.#########
#.#...#.#...#.#.....#...#
#.###.#.###.#.#######.#.#
#.....#.#...#.........#.#
#.#######.#############.#
#.........#...#.......#.#
#########.#.#.#.#####.#.#
#.......#.#.#...#...#.#.#
#######.#.#.#####.#.#.#.#
#.....#.#.#..S#.#.#.#.#.#
#.###.#.#.#####.#.#.#.#.#
#...#...#.#...#...#.#...#
#.#.###.#.#.###.###.#####
#.#...#.#.#.......#...#.#
#.###.###.#########.#.#.#
#...#...............#...#
#########################
