#########################
#.......................#
#####.#####.#########.###
#...#.....#.........#...#
###########.###.###.#####
#.........#...#...#.....#
#####.#.#.#.#######.#.#.#
#...#.#.#.#.......#.#.#.#
###.#########.#.###.#.###
#.#.........#.#...#.#...#
#.#.#####.#.#.#.#.#.#.###
#.#.....#.#.#.#S....#...#
#.###.###.#.#######.###.#
#...#...#.#.......#...#.#
#.#.#####.#.#.#####.#.###
#.#.....#.#.#.......#...#
#.###.#############.#####
#...#...................#
#.###.#########.###.###.#
#...#.........#.......#.#
#.#.#########.#.#.#.###.#
#.#.........#.#.#.....#.#
#.#.#.###.#.#.###.#.###.#
#.#.#...#.#.#...#.#...#.#
#######.#.#####.###.#.#.#
#.....#.#.....#....E#.#.#
#########################
