#########################
#...#.#.#.....#.....#...#
#.#.#.#.#.#.#.#.#####.#.#
#.#.....#E#.#...#...#.#.#
#######.#.#######.#.#.#.#
#.....#.#.......#.#...#.#
#.###.#.#.#####.###.#####
#.#.#.......#...#.#.#...#
#.#.###.#######.#.#.#.###
#.#.....#.....#.........#
###.#.###.###.#########.#
#...#.#.#...#.........#.#
###.#.#.###.###########.#
#...#.....#.......#.#...#
#########.###.#.###.###.#
#...#.......#.#...#.....#
###.###.#.#.###.#.#.###.#
#.......#.#.#...#...#...#
#.#########.#.#.#########
#.#.......#.#.#...#.#...#
#####.###.#.#####.#.###.#
#.......#.....#.#.......#
#.#######.#####.###.#.###
#.....#...#.....#...#...#
#.#.#####.#.#.#.#.#####.#
#.#.#.#...#.#.#...#...#.#
#.###.###########.#.###.#
#..............S#.#.....#
#########################
