#########################
#...........#...........#
#.###.#####.#.#######.###
#.#...#.....#.#.....#...#
#.#.#########.#.###.###.#
#.#.#...........#.#.#...#
#.#.#.###########.#.#.#.#
#.#...........#S#...#.#.#
#.#########.###.#.###.###
#.#...#.....#...#.#.#...#
#.#.#.#######.###.#.###.#
#.#.#.........#.......#.#
#.#.###################.#
#.#...#...........#...#.#
#.###.#######.###.#.#.#.#
#...#.#.......#.#.#.#E..#
#.###.#.#######.#.#.#####
#.#...#.#...#...#...#...#
#.#.###.#.###.#.#####.###
#.#.....#.....#.........#
#.#################.###.#
#...#.....#...#...#...#.#
###.###.#.#.#.#.#.#####.#
#.......#...#...#.......#
#########################
