#########################
#.....#...#.............#
#.#.###.#.#.#####.#####.#
#.#.#...#.#...#...#...#.#
#.###.###.###.#.###.#.#.#
#.#.....#...#.#.....#.#.#
#.#.#####.###.#######.#.#
#.#.#.#...#...#...#...#.#
#.#.#.#.###.###.#.#.###.#
#...#.#.......#E#.#.#.#.#
#.###.#########.#.#.#.#.#
#.........#.....#.#.#...#
#########.#.#####.#.#.###
#.....#...#...#.....#...#
#.###.#######.###########
#.#.........#.#.........#
#.#########.#.#.#######.#
#...#.....#...#.#.....#.#
#.#.#.###.###.#.#.###.#.#
#.#...#.#.#...#.#...#.#.#
#.#####.#.#.###.#####.#.#
#.....#.#.#.#...#...#.#.#
#####.#.#.###.###.#.#.#.#
#.....#.#.#.......#...#.#
#.#####.#.#.###########.#
#...#...#.#.#......S#...#
###.###.#.#.#.#######.#.#
#.......#...#.........#.#
#########################
