#########################
#...#.......#.........#.#
#.#.#.###.#.###.#####.#.#
#.#...#...#.....#.#...#.#
###.###.#########.#.###.#
#S#...#.....#.....#.#...#
#.#######.#.#.#####.#.#.#
#.#.....#.#.#.......#.#.#
#.#.###.###.#####.#####.#
#.#.#.#...#.....#...#...#
#.#.#.###.#####.###.#.#.#
#.#.#...#.#.....#...#.#.#
#.#.#.#.#.#.#####.###.#.#
#...#.#.#...#..E#.....#.#
#####.#######.#.#######.#
#.............#.#.....#.#
#.###########.###.###.#.#
#.#.........#...#.#.#...#
#.###.#####.###.#.#.#####
#...#...#...#.#.#...#...#
###.###.#.###.#.###.###.#
#.......#.....#.........#
#########################
