#########################
#..........S............#
###.###.#.###.###.###.###
#.#...#.#...#...#...#...#
###.#.###.#.#.###########
#.#.#...#.#.#...........#
###.#.#.#####.#.#.#.###.#
#.#.#.#.....#.#.#.#...#.#
#.#.#.###.#####.###.#.###
#...#...#.....#...#.#...#
#.#.#.#######.#########.#
#...#.......#.........#.#
#.#.#.###.#.#####.#.#.###
#...#...#.#.....#.#.#...#
###.#.###.#####.#.###.###
#...#...#.....#.#...#...#
###.#.#.#.###.#.#####.###
#...#.#.#...#.#.....#...#
#.#.#.#####.###.#######.#
#...#.....#...#.......#.#
#.#.#######.#####.#######
#.........#.....#.......#
###.###.###.#.#.###.###.#
#.#...#...#.#.#...#...#.#
#.#.#.###.#.###.#.#.#.###
#.#E#...#.#...#.#.#.#...#
#########################
