#########################
#.......................#
#.###.#.#.###.###.#.#.###
#...#.#.#...#...#.#.#...#
#.#.#######.###.#########
#.#.......#...#.........#
#.#.###.#.###.#####.###.#
#.#...#.#....S....#...#.#
###.#.#####.###.###.#####
#.#.#.....#...#...#.....#
#.#######.#.#.#.#####.###
#.......#.#.#.#.....#...#
###.#.#.###.#.###.#.#.###
#.#.#.#.....#...#.#.#...#
###.#.#.#.#.###.###.#.###
#.#.#.#.#.#...#...#.#...#
#.#.#.#.#.#.#####.#.#.###
#.#.#.#.#.#.....#.#.#...#
###.#.#.###.#########.#.#
#.#.#.#...#.........#.#.#
###########.#######.###.#
#.........#.......#...#.#
#.###.###.#.###.#.#.#####
#...#...#..E..#.#.#.....#
#####.#######.#.#.#.###.#
#...#.......#.#.#.#...#.#
#########################
