#########################
#.#S#.......#...#...#.#.#
#.#.#.#####.###.#.###.#.#
#...#.#.#.......#.......#
#.#.#.#.###.###.#######.#
#.#.#.#.#.#...#.......#.#
###.#.#.#.###.#########.#
#...#.#.#.....#.....#...#
###.#.#.#####.###.#.###.#
#.#.....#.....#...#.....#
#.###.#.#######.#.#####.#
#...#.#.......#.#.#...#.#
#.###########.#.#.###.#.#
#...#.#.........#.#...#.#
#.###.#######.#.#####.###
#...#...#.....#.......#.#
###.#.###.#.###.#.###.#.#
#...#...#.#...#.#.#...#.#
###.###.#.#####.#.###.#.#
#.#.#.......#...#...#...#
#.#.#######.#####.###.###
#...........#...#.#.#...#
#.###.#.#.###.#.###.#.###
#...#.#.#.#...#.....#...#
#.#######.###.#.###.#.###
#...#.......#.#..E#.....#
#########################
