#########################
#.......................#
#.#.#.#.###.###.#.#.#####
#.#.#.#...#...#.#.#.....#
#.#####.#.#.#.#.###.#.###
#.....#.#.#.#.#...#.#...#
#.#####.#.#####.#.###.#.#
#.....#.#.....#E#...#.#.#
#.###.#######.###.#####.#
#...#.......#...#.....#.#
#.###.###.###.#.#.#.#.###
#...#...#...#.#.#.#.#...#
#####.#.###.###.#.#.###.#
#...#.#...#...#.#.#...#.#
#.#.#.#.#.#######.#######
#.#.#.#.#.......#.......#
###.#.#.###.###.#.###.###
#.#.#.#...#...#.#...#...#
#####.#####.#######.#####
#...#.....#.......#....S#
###.#.#.#######.#.#.#.#.#
#.#.#.#.......#.#.#.#.#.#
#####.#.###.#.###.#.#####
#...#.#...#.#...#.#.....#
#########################
