#########################
#.........#.............#
#.#.#.###.#####.#####.###
#.#.#...#.....#.#.#.#...#
#.#.###.#######.#.#.#.###
#.#.#.#.#...#.#.....#.#.#
#.###.#.#.###.#######.#.#
#...#.......#...#.#...#.#
#.###.#####.#.###.###.#.#
#...#...#...#...........#
#.#.#.#.###.###.#.#######
#.#.#.#...#.....#.#.#...#
#.#.###.#.#######.#.###.#
#.#.#.#.#.#...#E........#
#.#.#.#####.#####.###.###
#.#.#.....#.....#...#...#
###.#.#.#######.#######.#
#...#.#.#...#.......#...#
###.#.#.###.#.###.#.#.#.#
#.....#.#.#.#...#.#.#.#.#
#.#####.#.#.#.#.#######.#
#.....#.#.....#.....#...#
#.#.#.###.#.#.#####.###.#
#.#.#.#.#.#.#.....#.....#
###.###.#######.###.###.#
#....S#.........#...#...#
#########################
