#########################
#.........#...........#.#
#.#####.###.#.#######.#.#
#.#.#...#...#.....#.#.#.#
#.#.#.###.#######.#.#.#.#
#.#.#...#...#...#.#.....#
#.#.###.###.#.#.#.#####.#
#E#.......#.#.#.#.....#.#
#.#########.#.#.#####.###
#.........#...#.#...#...#
#.#######.#####.###.###.#
#.....#.#.....#.#.....#.#
#####.#.###.###.#.#####.#
#...#.#...#...#.#.#...#.#
#.###.#.#.###.#.#.#.#.#.#
#.#...#.#.#.#...#.#.#...#
#.#.###.#.#.#####.#.###.#
#.#.....#.......#.#...#.#
#.#######.#####.#.###.#.#
#.....#...#...#...#...#.#
###.#.#.###.#.#####.###.#
#...#.#...#.#.....#.#.#.#
#.#######.#.#####.#.#.#.#
#.........#.#.......#...#
#.#########.#.###########
#.....#...#.#.#...#....S#
#####.###.#.###.#.#.#####
#.........#.....#.......#
#########################
