#########################
#.......................#
#.#.#.#.#.###.#####.#####
#.#.#.#.#...#.....#.....#
#########.#.###.#####.###
#......S#.#...#.....#...#
#.###.#.###.#.#.#.#.#####
#...#.#...#.#.#.#.#.....#
#.#.###########.###.#.###
#.#...........#...#.#...#
###.#######.#.###.#.#.###
#.#.......#.#...#.#.#...#
#####.#.###.#.###.#.#.###
#...#.#...#.#...#.#.#...#
#.###.###.#.#.#####.#.###
#...#...#.#.#.....#.#...#
###.#######.#.#.#.#.#####
#.#.......#.#.#.#.#.....#
#.#.#######.###.#.#.#.###
#.#.......#...#.#E#.#...#
#.#.###.#.#####.#####.#.#
#.#...#.#.....#.....#.#.#
#########################
