#########################
#.....#.........#...#.#.#
#.#####.#####.#.###.#.#.#
#.........#...#.#.......#
#.#.###.#############.###
#.#...#...#.......#...#.#
#.###.#####.###.###.#.#.#
#.#...#.#.....#.....#...#
#.#.###.#.#.###########.#
#.#.......#.....#.......#
###########.###.#######.#
#...#.......#...#.#...#.#
#.#.#####.#.#.###.#.#.#.#
#.#.....#.#.#.#...#.#...#
#.#####.#.###.###.#####.#
#.#.....#.#...#.....#...#
###.#.#####.###.#######.#
#...#.#.........#.#...#E#
#.#############.#.#.#.###
#.....#.............#...#
#.#####.#.#####.###.#.#.#
#.#.#...#.....#...#.#.#.#
#.#.###########.#########
#.............#...#.....#
###.###.#.#.#.###.#####.#
#.#.#...#.#.#.......#...#
#.#.#.#.#.#.###.###.#.###
#...#S#.#.#...#...#.....#
#########################
