#########################
#.......................#
#####.#.#.#####.###.#.###
#..S..............#.#...#
###############.#.###.###
#.............#.#...#...#
###########.###.#.#.#.#.#
#.........#....E#.#.#.#.#
#####.#######.#.###.#.#.#
#...#.......#.#...#.#.#.#
#######.#.###.#####.###.#
#.....#.#...#.....#...#.#
#.#.#####.#.#.#####.#.###
#.#.....#.#.#.....#.#...#
###.#########.#.#.###.#.#
#.#.........#.#.#...#.#.#
###.#############.#######
#.#.............#.......#
###.###.#.#.#####.#####.#
#.#...#.#.#.....#.....#.#
#############.###########
#...........#...........#
###.#.#.#####.#########.#
#.#.#.#.....#.........#.#
#########################
