#########################
#S..#.#.#.......#.......#
###.#.#.#.#####.#.#####.#
#.............#...#...#.#
#.###.###.#####.#.#.#.#.#
#.#...#...#.....#.#.#.#.#
###.#.###.#######.###.###
#...#...#.#.#...#.#...#.#
#.#########.#.###.#.###.#
#.#.#...........#.#...#.#
###.#####.#######.###.#.#
#.#.....#...#...#...#.#.#
#.#.###.#.###.###.###.#.#
#.#.#.......#.#.......#.#
#.#.#.#####.#.#.#######.#
#...#...#.......#...#...#
#.###########.#.###.###.#
#.#.....#...#.#...#.....#
#.###.#.#.###.#######.###
#.#.#.#.....#...#.#.#.#.#
#.#.#.#####.#.#.#.#.#.#.#
#.#.#...#...#.#.....#...#
#.#.#.#.#.###.#####.###.#
#.#...#.#...#...#.....#.#
#########.###.#########.#
#.#.#.......#...#.......#
#.#.#.#.#####.#.#####.#.#
#.....#..E....#.......#.#
#########################
