#########################
#............S#.#.#.#...#
###.#.#.#######.#.#.###.#
#...#.#.....#.....#.#...#
###.#####.#####.#.#.#.#.#
#.#.#.#.#...#.#.#.....#.#
#.###.#.###.#.###.#######
#.........#.#.....#.....#
###.###.###.#.###.#.#####
#.#...#...#.#.#.#.......#
#.###.#.###.###.#######.#
#...#.#.#...#...#...#...#
###.#.#.#.#.#.#.#.#.#.###
#.....#...#.#.#...#.....#
#.###.#.#########.#####.#
#.#.#.#........E#.....#.#
#.#.#.###.###.###.#####.#
#.#.#.#.....#.#.#...#...#
###.#######.#.#.#.###.###
#.......#...#.....#...#.#
#####.#.###.#####.###.#.#
#...#.#.......#.#.#.....#
#.#.###.#######.#.###.#.#
#.#.......#.......#...#.#
#########################
