#########################
#.......................#
#####.###.###.#####.#.###
#...#...#...#.....#.#...#
#################.#.#.#.#
#...............#.#.#.#.#
#.#.#.#.#.#####.#####.###
#.#.#.#.#.....#.....#...#
#.#######.#####.###.#.###
#.......#.....#...#.#...#
#.#.#.#.#######.#.#.#.#.#
#.#.#.#.......#.#.#.#.#.#
#.#####.#####.#####.#.###
#.....#.....#.....#.#...#
#.###.#####.#####.###.#.#
#...#.....#.....#...#.#.#
###.#.###.#.#.#.#####.#.#
#.#.#...#.#.#.#.....#.#.#
#.###.#.#.#####.#####.###
#...#.#.#..............S#
#.#.#######.###.#####.#.#
#.#........E..#.....#.#.#
#########################
