#########################
#.#.#.......#.......#...#
#.#.#.#.###.#.###.###.###
#.#...#...#.....#.#.....#
#.###.#.#.#.#.###.#.#.###
#E..#.#.#.#.#...#...#...#
###.#######.#####.#.###.#
#.#.........#...#.#.#...#
#.#.#.#####.#.###.#.#.###
#...#...#...#...#.#.#...#
###.###.###.#.###.#######
#.#.#...#.#.#.....#...#.#
#.###.#.#.#####.#.#.#.#.#
#.#...#.#.....#.#...#...#
#.###.#.#####.#########.#
#...#.#.#.........#...#.#
#.###.###.###.#####.#.#.#
#.....#.....#.#.....#...#
###.###.###.###.#.#.#####
#.....#.#.#...#.#.#.#.#.#
#.#######.#.#######.#.#.#
#.#S#...........#.....#.#
#.#.###.#.#######.###.#.#
#.#.....#...........#...#
#########################
