#########################
#.#...#...#..E..#.#...#.#
#.#.###.###.#.###.#.###.#
#...........#...#.......#
#.#.#.#####.#######.#.#.#
#.#.#.#.....#.......#.#.#
###.###.#########.#.#####
#...#.#...........#.#...#
#####.#####.#.#.###.#.#.#
#.........#.#.#...#.#.#.#
#.#########.#####.#.###.#
#.#.........#.#...#..S#.#
#.#.#.###.#.#.###.#####.#
#.#.#.#...#.#.....#.#.#.#
#.###.#####.#######.#.#.#
#...#...#.#.#.....#...#.#
#.###.###.#####.#.###.#.#
#.............#.#.......#
#######.#######.#.#####.#
#.......#.#.....#.#.#...#
#.###.#.#.#.#######.#####
#.#.#.#...#.........#...#
###.#####.###.#######.#.#
#.#.......#.#...#.....#.#
#.###.#.###.#.###.#######
#.....#.................#
#########################
