#########################
#S....#.....#.....#.....#
#####.#.###.#####.#.#####
#.........#.#.....#.....#
###########.###.#####.###
#.#.#...........#.......#
#.#.#.#####.#.###.#######
#.....#.#...#.#...#.#...#
###.#.#.#.#.#.#.###.#.###
#...#...#.#.#....E..#...#
#.#.#.#####.#.#.#######.#
#.#.#.....#.#.#...#.#...#
#.#########.#####.#.###.#
#.#...#.....#.........#.#
#.#.###############.#.#.#
#.......#.#.........#...#
###.#.###.#.###.###.###.#
#...#.....#...#.#...#...#
#.#.#.#######.#######.###
#.#.#.#.......#.........#
#########################
