#########################
#.........#.............#
#.#######.#.#####.#####.#
#S#...#...#...#...#...#.#
###.#.#.#####.#.###.###.#
#.#.#...#.#...#...#.....#
#.#.#####.#.#####.#####.#
#.#...#.........#.....#.#
#.###.#########.#####.#.#
#.....#...#...#.#.#...#.#
#.#####.#.###.#.#.#.#####
#.......#...#.....#.....#
###########.#####.#####.#
#.....#.....#...#.#.....#
#####.#.#####.#.###.###.#
#.....#...#...#...#...#.#
#.#######.#.#####.###.#.#
#.#...#...#E..#.#...#.#.#
#.#.#.#.#####.#.###.#.#.#
#...#.........#.......#.#
#########################
