#########################
#....................S..#
#.#####.#####.#.###.#.#.#
#.....#.....#.#...#.#.#.#
#.#.###.#.#.###.#.###.###
#.#...#.#.#...#.#...#...#
#.###.#####.#.#.#.#.#.###
#...#.....#.#.#.#.#.#...#
#######.#########.###.#.#
#.....#.........#...#.#.#
###.#.###.#######.#.#.#.#
#.#.#...#.......#.#.#.#.#
#.#######.#.###.###.###.#
#.......#.#...#...#E..#.#
#.###.#.###.#.#######.#.#
#...#.#...#.#.......#.#.#
#.#.#.###.#.#.#.#.#.#.###
#.#.#...#.#.#.#.#.#.#...#
#############.#.#########
#...........#.#.........#
#.#.#.#.###.#.###.#.#####
#.#.#.#...#.#...#.#.....#
#.#####.###.#.###.#######
#.....#...#.#...#.......#
#########################
