#########################
#.......................#
#.###.#.#.###.###.#.#####
#...#.#.#...#...#.#.....#
#.#.###.#####.#.###.#.###
#.#...#.....#.#...#.#...#
###.#.###.#.#.#######.###
#.#.#...#.#.#.......#...#
#.#####.#####.#.#.#.#.#.#
#................E#.#.#.#
###.#######.#############
#.........#.............#
#.#.#.#.###########.#####
#...#.#...........#.....#
###.#.#.#####.#.###.#.###
#...#.#.....#.#...#.#...#
#.#.#.###.#####.#######.#
#.#S#...#.....#.......#.#
#.#######.#.#####.#.#.###
#.......#.#.....#.#.#...#
#.###.###########.#.###.#
#...#...........#.#...#.#
#########################
