#########################
#.......#.#.............#
#.#####.#.#.###.#########
#...#.....#...#.#.......#
#.#.#########.#.#.#####.#
#.#...........#...#.....#
#########.#########.###.#
#.......#.#.......#...#.#
#.#####.#.#.#####.###.#.#
#...#.#.#.#.#...#.....#.#
###.#.#.#.#.#.#.#######.#
#.#.#.#S#.#.#.#...#...#.#
#.#.#.#####.#.#.#.#.###.#
#.#.#.......#.#.#.#.#..E#
#.#.#####.###.#.#.#.#.###
#.#.......#...#.#.#.#...#
#.#############.#.#.###.#
#.......#.......#.....#.#
#.#####.#.#.#######.###.#
#.#...#.#.#.#.....#.#...#
#.#.#.###.#.#.###.###.###
#...#.....#.....#.......#
#########################
