#########################
#.#...............#.....#
#.#.###.#.###########.###
#.#...#.#E..#.#.#.......#
#.#######.###.#.#.###.#.#
#.......#...#.#...#...#.#
#######.#.#.#.#.###.#.#.#
#.....#.#.#.......#.#.#.#
###.###.#.###.#.#####.###
#.#...#.....#.#.#...#.#.#
#.#.#.#.#.###.###.###.#.#
#...#.#.#...#.#.........#
###.#.#.###.#.###.#.###.#
#...#.#.#...#...#.#...#.#
#.#.#.###.#.#######.###.#
#.#.#.#...#...#.#.#.#...#
#.###.#######.#.#.###.#.#
#.#...#.#...#.#.....#.#.#
#####.#.#.#####.###.#.###
#...#.....#.......#.#.#S#
###.#####.#.#.#.#####.#.#
#...........#.#.........#
#########################
