#########################
#...........#...#...#...#
#######.#.###.#.#.#.#.#.#
#.....#.#.#...#.#.#...#.#
#.###.#.###.###.#.#####.#
#.#...#...#.#...#.#.....#
#.#.#####.#.#.###.#.###.#
#.#.......#.#.#...#.#...#
#.#########.#.#####.#.###
#.........#S#...#...#...#
#.#######.#####.#.#####.#
#.#...#...#...#.#...#...#
#.#.#.#.###.#.#.###.#####
#.#.#.#.#...#.#...#.....#
#.#.#.#.#.###.###.#.###.#
#...#.#.#...#.....#.#...#
#.#####.###.#########.#.#
#.#.....#...#.....#...#.#
#.#.#####.#####.#.#.###.#
#.#.....#...#...#.#.#...#
#.#####.###.#.###.#.#.###
#.#...#...#...#.#...#...#
#.###.###.#####.#######.#
#...#...#...........#...#
###.#.#.###.#########.###
#.....#...#....E........#
#########################
