#########################
#.........#...#.........#
#######.#.#.#.#.#######.#
#...#...#.#.#...#.......#
#.#.#.###.#.#####.#####.#
#.#...#...#.#.....#...#.#
#.#####.#####.#####.###.#
#.#.........#...#.......#
#.#########.#.#.#####.###
#..E....#...#.#.....#.#.#
#.#####.###.#####.#.#.#.#
#.#...#...#.....#.#.#...#
#.###.###.#####.#.#.###.#
#.......#.#...#.#.#.#...#
#######.#.#.###.#.#.###.#
#.#...#.#.#.....#.#...#.#
#.#.#.#.#.#####.#####.###
#...#...#.....#.......#S#
#.###########.#######.#.#
#.#.........#...#...#.#.#
#.#####.#######.#.#.#.#.#
#.......#.......#.#...#.#
#######.#.#######.#####.#
#...#...#.#.......#.....#
#.#.#.###.#####.###.#####
#.#...#...#...#...#.#...#
#.#####.###.#.#####.#.#.#
#.....#.....#.........#.#
#########################
