#########################
#E......................#
#.#####.#.#.#######.#####
#.....#.#.#.......#.....#
#####.#####.###.#.###.#.#
#...#.........#.#...#.#.#
#######.###.#.#.###.#.#.#
#.....#.....#.#...#.#.#.#
#.###.#####.#.###########
#...#.....#.#...........#
#.#########.#.###.###.###
#...........#...#...#...#
#.###.###.#.###.#.#.#####
#...#...#.....#.#.#.....#
###.###.#.#.#.#.#.###.###
#.#...#.#.#S#.#.#...#...#
#.#.#####.#.#.###.###.#.#
#.#.....#.#.#...#...#.#.#
###############.#.#.#.###
#.............#.#.#.#...#
#.#####.#.#.#.#.#.###.###
#.....#.#.#.#.#.#...#...#
###.###########.#######.#
#.#...........#.......#.#
###.#####.#.#.#.#.#####.#
#.#.....#.#.#.#.#.....#.#
#.#######.###.###.#####.#
#.......#...#...#.....#.#
#########################
