#########################
#.......................#
#####.#####.#.###.#######
#...#.....#.#...#.......#
###.#####.#.#.#.###.#.#.#
#.#.....#.#.#.#...#.#.#.#
#.#####.#.#.#######.#.#.#
#.....#.#.#.......#.#.#.#
#####.#.#########.#.#.###
#...#.#.........#.#.#...#
#.#######.#.###.#.###.#.#
#.......#.#...#.#...#.#.#
#.#.#.#.#.#.#######.#.###
#.#.#E.................S#
#.#######################
#.......................#
#####.#.#.#####.###.#.###
#...#.#.#.....#...#.#...#
#.#.###########.###.#.#.#
#.#...........#...#.#.#.#
#########################
