#########################
#.......................#
#.#####.###.###.###.###.#
#.....#...#...#...#...#.#
#.#.#.###.#.#############
#.#.#...#.#.............#
#####.#.#.###.###.#####.#
#...#.#.#...#...#.....#.#
#######.###.#########.###
#..E.................S..#
#.###.#.###.#####.#######
#...#.#...#.....#.......#
###############.#.#####.#
#.............#.#.....#.#
#.#.#.#.#.#.#.#####.###.#
#.#.#.#.#.#.#.....#...#.#
#.#.#####.###.#.#.#.#.###
#.#.....#...#.#.#.#.#...#
#.#.#.#.#######.#.#####.#
#.#.#.#.......#.#.....#.#
#########################
