#########################
#.......#...#.......#...#
#.#.###.#.#.#####.#.###.#
#.#...#...#...#...#...#.#
#.###.#######.#.#####.#.#
#.#.#.....#...#...#.....#
#.#.#####.#.###.#.#######
#.......#.#...#.#.......#
#####.###.###.###.#####.#
#.....#...#.#...#.#..E..#
#######.###.###.#.#.###.#
#.....#.#...#...#.#.#...#
#.###.#.#.###.#####.#.###
#.#...#.#.#...#.....#.#.#
#.#.###.#.#.#####.###.#.#
#.#.#S#.#.#.......#.#.#.#
#.#.#.#.#.#########.#.#.#
#.#...#.#...........#.#.#
#.#####.#.#######.###.#.#
#.#.....#...#...#.....#.#
#.#.#######.#.#.#######.#
#...#.........#.........#
#########################
