#########################
#.......#.....#.....#...#
#.#.#####.#.#.#.###.#.#.#
#.#.......#.#.#...#...#.#
#.#########.#.###.#####.#
#.....#.....#...#.#.#...#
###.###.#.#######.#.#.###
#.#.#...#.#.....#...#...#
#.#.#.#####.###.###.###.#
#...#.......#.#..E#.#.#.#
#.###########.###.#.#.#.#
#.#.............#.....#.#
#.###.#########.#######.#
#...#...#.....#.#.#.....#
###.###.#.#.###.#.#.###.#
#.#.#...#.#.#...#.#.#...#
#.#.#.###.###.###.#.#####
#.....#...........#.....#
#########.###.#######.#.#
#.......#.#S#.#.....#.#.#
#.#####.###.#.#.###.###.#
#.....#.....#.#.#.#...#.#
#####.#########.#.###.#.#
#...............#.......#
#########################
