#########################
#...#...#.....#S#.......#
#.#.#.#.#.#####.#.#.#.###
#.#.#.#.....#.....#.#...#
#.#.#####.###.#######.#.#
#.#.#.........#.....#.#.#
###.#.#.#######.###.###.#
#.#...#.....#.....#.#...#
#.#######.#####.#.###.###
#.#.......#.....#.#.....#
#.#####.###.###.#######.#
#...#...#.....#.#...#.#.#
#.###.#####.#######.#.#.#
#.#.#...#.........#.#...#
#.#.#.#.#.#.#.#.###.#.#.#
#.#.#.#.#.#.#.#.....#.#.#
#.#.###.#####.#.#.###.#.#
#.........#...#.#.#...#.#
#.###.#####.#.#####.###.#
#.#E........#...#...#...#
#########################
