#########################
#...#.#.......#.........#
#.#.#.#.###.#.#.#####.#.#
#.#...#.#.#.#.#.....#.#.#
#.#####.#.#.#.#####.#.###
#.#.......#.#.....#.#...#
#.#.#######.#####.#####.#
#.....#.....#...........#
#.#####.#.#############.#
#.#...#.#.#.......#...#.#
#.#.#.#.###.#####.#.###.#
#.#.#.#...#...#...#.#...#
###.#.###.###.#.###.#.###
#...#...#...#.#...#.#.#.#
#.#####.###.#.###.#.#.#.#
#.#...#...#.#...#.#.....#
#.#.#####.#.###.#.#####.#
#.#.....#.#.#...#.#...#.#
#.###.#.#.#.#.###.#.#.#.#
#...#.#...#...#.#...#.#.#
#.#.###.###.###.#####.#.#
#.#...#.#.........#...#.#
#.###.#.###########.###.#
#.#S#.#.......#...#.#E#.#
#.#.#.#######.#.#.#.#.#.#
#.#...#.........#...#...#
#########################
