#########################
#.........#.............#
#.#######.#.#########.#.#
#.#...#S..#.....#...#.#.#
#.###.#####.#####.#.###.#
#.#.....#...#.....#...#.#
#.#.###.#####.#######.#.#
#.#.#...#.....#.#.....#.#
#.#.#.###.#####.#.#####.#
#...#.....#...#...#.#...#
#############.#.###.#.#.#
#.........#...#.#.....#.#
#.###.###.#.#.#.#######.#
#.#.#.#.....#E#.......#.#
#.#.#.###.###########.#.#
#...#...#.#.........#.#.#
###.###.#.#.###.#####.#.#
#.#...#.#.#.#.#...#...#.#
#.###.#.###.#.###.#.###.#
#.....#.........#.......#
#########################
