#########################
#.....#.#...#...#..E#...#
###.###.#.#.#.#####.#.###
#...#.....#.#...#.......#
#.#####.#.#####.#.#.###.#
#.#.#...#.#...#.#.#.#...#
#.#.#.#####.###.###.###.#
#.#.#.....#...........#.#
#.#.#.###.#.#####.#.#.#.#
#.......#.#.....#.#.#.#.#
#########.###.#.###.#.###
#.#.#...#...#.#...#.#.#.#
#.#.###.###.#.#######.#.#
#.#.#.......#.....#.#...#
#.#.#######.###.#.#.###.#
#.#...#.........#.....#.#
#.#.#####.###.#####.#.###
#...#.......#.#.#.#.#..S#
#.###.#######.#.#.#.#####
#.....#.......#.........#
#########################
