#########################
#...#S..........#.....#.#
#.#.###.#.###########.#.#
#.#...#.#.#...#.#...#...#
###.###.#####.#.###.###.#
#.#...#...#.#.....#...#.#
#.#.#.###.#.###.###.###.#
#...#.....#.........#.#.#
###.#####.#.#########.#.#
#.....#.#.....#...#.#...#
#######.#.#######.#.#.###
#...#.#...#.#...........#
#.#.#.###.#.#####.#####.#
#.#.#......E#...#.....#.#
#.#.###.#.#####.###.#.#.#
#.#.#...#.#...#.#.#.#.#.#
#.#.###.#.###.#.#.#.#####
#.#...#.#...#.......#...#
###.###.###.#####.#.#.#.#
#.......#.........#...#.#
#.#######.#.###.#.###.###
#.#.......#.#...#.#.....#
#########################
