#########################
#.......................#
#.#.#.###########.#.###.#
#.#.#...........#.#...#.#
#####.#####.#####.###.#.#
#...#.....#........S#.#.#
#.#.###.#.#.#############
#.#...#.#.#.............#
#.#########.###.#########
#.........#...#.........#
###.#.#.#.#.#.#.#######.#
#.#.#.#.#...#.#.......#.#
###.#.#.#.#.###.#.#####.#
#.#.#.#.#..E..#.#.....#.#
#.#.#.#.#####.###.#######
#.#.#.#.....#...#.......#
#.###.#.###.###.#########
#...#.#...#...#.........#
#.#######.#.#############
#.......#.#.............#
###.#.#.#.#.#######.#.#.#
#.#.#.#.#.#.......#.#.#.#
#####.###.#######.#.#.###
#...#...#.......#.#.#...#
###.#.#.###.###.#.###.###
#.#.#.#...#...#.#...#...#
###.#.###.###########.#.#
#.#.#...#...........#.#.#
#########################
