#########################
#...#...........#...#.#.#
###.#.#####.###.#.###.#.#
#S#...#.....#...#.......#
#.#######.#####.###.#####
#...#...#.#.....#...#...#
###.#.###.#####.#.#.###.#
#.......#...#.#.#.#.#...#
#.#.###.#.###.#.#.#.#.###
#.#...#.....#.#...#...#.#
#.###.###.###.###.#.###.#
#.#...#.#...#.#...#.....#
###.###.#####.###.###.#.#
#.#.#.#...........#...#.#
#.#.#.###.#######.#.#####
#.....#...#.......#...#.#
#.###################.#.#
#.#.......#...#.#...#.#.#
#.#####.###.#.#.#.###.#.#
#...........#.#...#.....#
###.###########.#######.#
#.#E#.......#...#...#...#
#.###.###.###.###.#####.#
#.....#.................#
#########################
