#########################
#..E..#.............#...#
#.###.#.#.#########.#.#.#
#.#.#.#.#.....#...#...#.#
#.#.#.#.#####.#.#.#####.#
#.#...#.#.....#.#.#.....#
#.#.###.#.#####.###.#####
#.#.#...#...#.........#.#
#.###.#####.#########.#.#
#.......#...#.....#.....#
#########.#.#.###.#####.#
#.....#...#.#.#.#.....#.#
#.###.#.#####.#.#####.#.#
#.#.#.#.....#...#.....#.#
#.#.#.#####.#.###.#####.#
#.#.#...#S#...#...#...#.#
#.#.###.#.#####.###.#.#.#
#...#.#...#...#...#.#.#.#
###.#.#####.#.###.#.###.#
#...........#.....#.....#
#########################
