#########################
#.#...#.......#...#.....#
#.#.#.#.#.###.#.###.###.#
#...#.#.#.#...#.....#...#
#.###.#.#.###.#######.#.#
#...#...#...#.........#.#
###.#######.###########.#
#...#...#...#.........#.#
#.###.#.#.###.###.#####.#
#.....#.#.#.#...#.#.....#
#.#######.#.#.#.###.#####
#.#.......#...#.#...#...#
###.#######.###.#.#####.#
#..E#.....#.#.#...#.....#
#.###.#####.#.#####.#.#.#
#...#.#...#.#.#.....#.#.#
#.#.#.#.#.#.#.#.#####.#.#
#.#.#...#.#.#.......#.#.#
###.#####.#.#########.###
#...#...#...........#...#
#.###.#.#.#########.###.#
#.#...#.#...#S..#.#...#.#
#.#.###.###.###.#.###.#.#
#.#...#.#...#...#.....#.#
#.###.#.#.###.###.#####.#
#.#...#.#...#.#...#.....#
#.#.###.#####.#.###.###.#
#.#.#.#.#.....#.#.....#.#
#.#.#.#.#.#####.#####.#.#
#.....#...#...........#.#
#########################
