#########################
#.#...#.....#.....#.#.#.#
#.###.#.###.###.###.#.#.#
#...#.....#.#.....#...#.#
#.#########.#.#.#####.#.#
#.#...........#...#.....#
#.#.#####.#.###.###.#####
#...#.....#.#.....#.#.#.#
#####.#.#####.#####.#.#.#
#.....#.#.#.#.........#.#
#.#####.#.#.#.#####.#.#.#
#...#...#...#.....#.#...#
###.#.#.###.#.#.###.###.#
#...#.#.#.#...#...#.#...#
#######.#.#####.#######.#
#.............#...#.....#
#.###.###.###.###.###.###
#...#.#.....#...#...#...#
#.#################.#.###
#.#...#.......#.....#...#
#.###.#.###.#.#.#.#####.#
#.#...#...#.#...#...#E..#
#####.###.#########.#####
#...#.#...#.............#
#.#.#.#######.###.#####.#
#.#.....#.....#.#.#.#.#.#
#.#.###.#######.#.#.#.#.#
#.#.#...#.........#.....#
#.###.#.#.#######.###.#.#
#..S#.#.....#.....#...#.#
#########################
