#########################
#...#S#.....#...........#
#.#.#.#.###.#####.#####.#
#.#.#.#.#.#.#...#.....#.#
#.#.#.#.#.#.#.#.#######.#
#.#.#.#.#.#...#.......#.#
#.#.#.#.#.###########.#.#
#.#.#...#.......#...#.#.#
#.###########.#.#.#.#.#.#
#.......#.....#...#.#.#.#
#.###.#.#.#########.#.#.#
#.#...#...#.....#E..#...#
###.#######.#####.#####.#
#...#.......#.......#...#
#.###.#.###.#.#######.###
#...#.#.#...#...#.....#.#
###.#.#.#.#####.#.#####.#
#...#.#.#.....#.#.#.....#
#.###.#.###.###.#.#.###.#
#...#.#...#.#...#.#.#...#
#.#.#.###.###.###.#.#.###
#.#.#...#.......#.#.#...#
###.###.#########.#.###.#
#...#.#.....#.....#...#.#
#.###.#####.#.#########.#
#.#.....#...#...#.......#
#.#.#####.#####.#.#.###.#
#.#.......#.....#.#.#...#
#.#########.#######.#.###
#...................#...#
#########################
