#########################
#.#.#.....#.#.........#.#
#.#.###.###.#.#.#.#####.#
#...#.#..E#...#.#.#.....#
###.#.###.###.#.#.#.#.###
#.#.#.#.......#.#.#.#.#.#
#.#.#.###.###.#.###.###.#
#.#.#.......#.#.#.#...#.#
#.#.#####.#.#####.###.#.#
#.#.......#.#.#...#.#.#.#
#.#.###.#####.#.###.#.#.#
#.#.#.#...#.#.#.#.....#.#
#.#.#.#.###.#.#.#####.#.#
#.#.#.#.#.....#...#.#.#.#
#.#.#.###.###.###.#.#.#.#
#.....#...#.......#.#...#
#.#.###.#####.#####.#.###
#.#.....#.....#.....#...#
#.#.#########.#.#.#####.#
#.#...#.#...#...#.#...#.#
#.#.#.#.#.#####.###.###.#
#.#.#.......#.#.#.#.#.#.#
#.###.#######.#.#.#.#.#.#
#.#S#.#.......#.#.#.....#
#.#.#.###.###.#.#.###.###
#.#...#.#...#.#.....#...#
###.#.#.#.###.#.###.#.#.#
#.#.#...#...#.#.#.....#.#
#.#.#.#.###.#.#.#####.###
#...#.#.#...#.......#...#
#########################
