#########################
#......................S#
#####.#######.#####.#####
#.......#...#...#.....#.#
#######.###.#.###.###.#.#
#...........#.#.#...#...#
#####.###.#####.###.#.###
#.....#...#...#.#...#...#
#####.###.#.#.#.#########
#.....#...#.#.....#.....#
#.#.#####.#.###.#.#.#.#.#
#.#...#...#.#...#...#.#.#
#.#####.#.#####.#####.###
#...#.#.#.....#...#.....#
#.#.#.#######.###.#####.#
#.#...#.#.#...........#.#
###.#.#.#.#.###.###.#.###
#..E#.#.#.....#.#.#.#...#
###.###.#####.###.#######
#.......#.#.#.#...#.....#
#####.###.#.#.#.###.#####
#.#.#.#.......#.....#.#.#
#.#.#.#.#.#####.###.#.#.#
#.#.#.#.#.....#...#...#.#
#.#.#.#####.#.#####.###.#
#.......#.#.#.#...#.....#
###.#####.#.#.###.###.#.#
#.#.#.....#.#.......#.#.#
#.#.#.#.#####.###.###.###
#...#.#.......#.........#
#########################
