#########################
#.#.....#.......#.....#.#
#.#.#.#.#####.#.#.###.#.#
#...#.#.....#.#...#...#.#
#.###.#####.#.#####.###.#
#.#.#.....#...#...#...#.#
#.#.#####.#######.###.#.#
#.......#...#...#.#...#.#
#########.#.#.#.#.#.###.#
#.......#.#...#.#...#...#
#.#####.###.###.###.###.#
#.#...#...#...#...#...#.#
#.#.#.###.###.###.###.#.#
#...#.#...#.....#.#...#.#
#.###.#.###.#####.###.#.#
#.#...#...#.#...#E..#.#.#
###.#####.###.#.#.#.#.#.#
#S..#.#...#...#.#.#.#.#.#
#####.#.###.###.###.#.#.#
#...#...#...#...#...#...#
#.#.#.###.###.###.#####.#
#.#.#.....#...#...#...#.#
#.#########.#####.#.#.###
#.#.......#.#...#...#...#
#.#.###.#.#.#.#.#######.#
#...#...#.#...#.#.......#
#.###.#########.#.#####.#
#...#.#...#...#.#...#.#.#
###.#.#.#.#.#.#.###.#.#.#
#...#...#...#.......#...#
#########################
