#########################
#.......................#
###.#.#.#######.#.#.###.#
#.#.#.#.......#.#.#...#.#
#####.#.###.#.#.#.#.#.###
#...#......S#.#.#.#.#...#
#####.#.#.#####.#.#.###.#
#.....#.#.....#.#.#...#.#
#.###.#.#.###.#######.###
#.....#.#...#.......#...#
#####.#######.#####.#.#.#
#...........#.....#.#.#.#
#.###.#.###.#####.###.#.#
#...#.#...#.....#...#.#.#
#.###.#.#.#####.#.#.#.###
#.....#.#.....#.#.#.#...#
#.###.###.#.#.###.#.#.#.#
#....E..#.#.#...#.#.#.#.#
#.###.###.###.#.###.#.#.#
#...#...#...#.#...#.#.#.#
###.#.#.#.#.#.#.#.#####.#
#.#.#.#.#.#.#.#.#.....#.#
#######.#.#######.#.###.#
#.....#.#.......#.#...#.#
#####.#####.###.#######.#
#...#.....#...#.......#.#
#.#########.#.###.#.###.#
#.........#.#...#.#...#.#
#.###.#.#######.#####.###
#...#.#.......#.....#...#
#########################
