#########################
#.......................#
#.#####.###.#.###.#####.#
#.....#...#.#...#.....#.#
###.#.#####.#.#.#.###.###
#.#.#.....#.#.#.#...#...#
#####.#.###.###.#.#####.#
#...#.#...#E..........#.#
#.#.#.#####.###.#.#.###.#
#.#.#.....#...#.#.#...#.#
###.#.#.###.#####.#.###.#
#.#.#.#...#.....#.#...#.#
#.###.#.###.#####.#.#.#.#
#...#.#...#.....#...#.#.#
###.###.###.#.#.#.#.#####
#.#...#...#.#.#.#.#.....#
#.#.#######.#.#.#.#.#.###
#.#.......#.#.#.#.#.#...#
#.#####.#####.#.###.#.#.#
#.....#.....#.#...#.#.#.#
###.#######.#####.#.###.#
#.#.......#.....#.#...#.#
#.#.#.#.#########.#.###.#
#.#.#.#.........#.....#.#
#.#.#.#.#.###.#.###.#.#.#
#.#.#.#.#...#.#.....#.#.#
#.#.#.#.###.#####.#.#.###
#.#.#.#...#.....#.#S#...#
#.#.#.#.#########.#.#.###
#.#.#.#.........#.#.#...#
#########################
