#########################
#.......................#
#.#.#.#.#.#####.###.###.#
#.#.#.#.#.....#...#...#.#
#.#####.#.#.###.#.#.#####
#.....#.#.#...#.#.#.....#
#.#.#.#####.###.###.#.###
#.#.#.....#...#...#.#...#
#.###.#.#####.#.#######.#
#...#.#.....#.#.......#.#
#.#.#####.###.###.#######
#.#.....#...#...#.......#
###.#.#######.#######.#.#
#.#.#.......#.......#.#.#
###.#####.#.#.###.#####.#
#.#.....#.#.#...#.....#.#
###########.#.###.#.#.#.#
#.........#.#...#.#.#.#.#
#.#.#.#####.#############
#.#.#.....#.............#
#####.#####.#.###.###.#.#
#...#.....#.#...#...#.#.#
###.#.###.#######.###.#.#
#E......................#
#####.#.###.###.###.###.#
#...#.#...#...#...#....S#
#.#####.#.#.#.###########
#.....#.#.#.#...........#
#.#.#.###.###.###.#######
#.#.#...#...#...#.......#
#########################
