###########################
#.........................#
#####.###################.#
#...#...................#.#
#.#.#.###.#.#####.#.#####.#
#.#.#...#.#.....#.#.....#.#
#######.#.#.###.#.#.###.###
#.....#.#.#..S#.#.#...#...#
#########.#.#######.#.###.#
#.......#.#.......#.#...#.#
###.#.#####.#.#.#.###.###.#
#.#.#.....#.#.#.#...#...#E#
#.###.#.#.###.#.#.#########
#...#.#.#...#.#.#.........#
###########################
