###########################
#.......#.......#.....#...#
###.###.###.###.#.###.###.#
#S..#.#...#...#...#.#.....#
#####.###.###.#####.#####.#
#.#.....#...#.....#.......#
#.#.#.#####.#.###.#.#######
#.#.#.#.....#.#E#.#.......#
#.#.#.#.#####.#.#.#######.#
#.#.#...#.......#.#...#...#
#.#.###########.#.#.###.###
#.#.#.........#.#.#.#...#.#
#.#.###.#.###.###.#.#.###.#
#.#...#.#.#.#.....#.#.....#
#.###.###.#.#######.#####.#
#.........#...............#
###########################
