###########################
#.......#.#.#...#.#...#..S#
#.#######.#.#.###.###.#.###
#.....#.#.#...#.#.......#.#
#.###.#.#.###.#.#######.#.#
#...#.#.#.#.......#.#.....#
#.###.#.#.#.#.#####.#.#####
#...#.#.#...#.#.......#...#
###.###.#####.#.###.###.###
#.........#...#...#.......#
#########.#.#.###.###.#####
#.#...#.....#.#.#...#.....#
#.#.###.#####.#.#.#.#####.#
#...#...#.#.......#.#.#...#
#.#.#.###.#.###.#.#.#.#.###
#.#.......#...#.#.#.#E....#
###########################
