###########################
#.............#...........#
#.#######.###.###.#########
#.#...#...#.#.....#.......#
#.#.#.#.###.#.#####.#####.#
#.#.#.#...#...#...#.#...#E#
#.#.#####.#.###.#.#.#.###.#
#...#.....#.#...#.....#...#
#####.#####.#.#########.#.#
#...#.#.....#.#.....#...#.#
#.#.#.#######.#.###.#.###.#
#.#...#.....#.#.#...#.#...#
#.#####.###.#.###.#.#.#####
#.#...#.#.#...#...#.#.....#
#.#.#.#.#.#####.#####.###.#
#.#.#.#...#.......#S#...#.#
#.#.#.###.#######.#.#####.#
#...#.............#.......#
###########################
