###########################
#.....#.......#...#.......#
#.###.#.#####.#.#.#.#.#####
#.#...#...#S#...#...#.....#
#.#.#######.#.#########.#.#
#.#...#.....#...#.....#.#.#
#.###.#.#######.#.###.###.#
#.#.#...#.....#.#...#.....#
#.#.#########.#.###.#####.#
#.#.......#...#.#.#.#...#.#
#.#.#####.#.###.#.#.#.#.#.#
#.#...#...#.#.....#.#.#.#.#
#.###.#.###.#.#####.#.###.#
#...#.#.#.....#.....#.#...#
###.#.#.#######.#####.#.###
#.#..E#.......#.#.#...#.#.#
#.###########.#.#.#.#.#.#.#
#...............#...#.....#
###########################
