###########################
#.........................#
#.#.#.#####.#.#.###.#.#.###
#.#.#.....#.#.#...#.#.#..S#
#######.#.###.#.#####.###.#
#.....#.#...#.#.....#...#.#
###.###.###.#########.###.#
#.#...#...#.........#...#.#
#.###.###.#.#.#.###.###.###
#...#...#E#.#.#...#...#...#
###########################
