###########################
#.........................#
#####.#.#.#.#####.#.###.###
#...#.#................E..#
#.#####.#####.#.#####.#.#.#
#...........#.#.....#.#.#.#
#.#####.#########.#.###.###
#.....#S........#.#...#...#
###############.#####.###.#
#.............#.....#...#.#
#.#.###.###.#######.###.#.#
#.#...#...#.......#...#.#.#
###########################
