###########################
#S#.......#...#.......#...#
#.#.#####.#.#.#.#.###.###.#
#...#.....#.#...#.#.#...#.#
#####.###########.#.###.#.#
#.....#...........#....E#.#
#.#####.###########.#####.#
#.#...#...#.....#...#.....#
#.#.#.###.#.#####.#####.#.#
#...#.....#.............#.#
###########################
