###########################
#.#S..............#...#.#.#
#.###.#.#########.#.#.#.#.#
#...#.#.#...#.....#E#.....#
###.###.###.#.#######.#####
#.....#...#...............#
#.###################.#.#.#
#.........#.#.#.#.....#.#.#
#.#.#######.#.#.###.#####.#
#.#.#.#.......#...#.....#.#
###.#.###.###.###.#######.#
#...#.......#.#...........#
###.###.###.###.###.#######
#...#...#.....#.#.#.#.....#
#.#.#######.#.#.#.#.#.#.###
#.#.........#...#.....#...#
###########################
