###########################
#.........................#
#####.#########.#####.#.#.#
#...#..E......#.....#.#.#.#
#########.#.###.#####.#####
#.......#.#...#.....#.....#
#.#.###.#.#.#.#.#.###.#.###
#.#...#.#.#.#.#.#...#.#...#
#.#.#.###.#.#####.#.#.#.#.#
#.#.#...#.#....S#.#.#.#.#.#
#.#########.#.#.###.#.###.#
#.........#.#.#...#.#...#.#
#.#.#####.#.#########.#.###
#.#.....#.#.........#.#...#
#.#.#.#.#.#.#####.#.#.#####
#.#.#.#.#.#.....#.#.#.....#
###.#.###.#.#####.#.#####.#
#.#.#...#.#.....#.#.....#.#
###########################
