###########################
#...#S..#.....#...#.......#
#.#####.#.###.#.#.#.#####.#
#.....#.#.#.#.#.#.#...#.#.#
#.#.#.#.#.#.#.#.#.###.#.#.#
#.#.#.#...#..E#.#...#...#.#
#.#.#######.###.###.#####.#
#.#.......#.#...#.#.......#
#.#####.#.#.#.###.#######.#
#.#.#...#.#...#.........#.#
#.#.#.#########.#######.#.#
#...#.................#...#
###########################
