###########################
#.#E#.#.....#.........#.#.#
#.#.#.#.#######.###.#.#.#.#
#.................#.#.....#
#######.#.#######.#######.#
#...#...#.#.....#.#...#...#
#.###.###.#.#.#.#.#.#.#.###
#.#...#...#.#.#.#...#.#..S#
#.#.###.#.#.###.###.#.#####
#...#...#...#...#...#.....#
###########################
