###########################
#S......#.#.#.....#.#.#.#.#
#######.#.#.###.#.#.#.#.#.#
#...#.#.....#...#.....#.#.#
#.#.#.#####.#.###.###.#.#.#
#.#...#.........#.#.....#.#
#####.#####.#.###.#######.#
#.........#.#.#.#E........#
###.#.###.###.#.#.#.#######
#...#.#...#.#.#...#.#.#...#
###.###.###.#.#.###.#.#.###
#...#.........#...#.......#
###########################
