###########################
#S................#.....#.#
#################.#.###.#.#
#.....#.........#.#.#.#E#.#
#.#.#.#.###.#####.#.#.#.#.#
#.#.#.#.#.#.....#...#...#.#
#.#.###.#.#####.#####.###.#
#.#.#...#.....#.#...#...#.#
#.#.#.#####.###.#.#.###.#.#
#.#.#.....#...#...#...#.#.#
#.#.#####.###.#######.#.#.#
#.#.................#.....#
###########################
