###########################
#.........................#
#.#.#####.#####.###.#######
#.#.....#.....#...#.......#
###.#.#####.#.#.###.#.###.#
#.#.#E....#.#.#...#.#..S#.#
###.#.#.#####.#.#.#.#.#.#.#
#.#.#.#.....#.#.#.#.#.#.#.#
###.###.#####.#.#.#.###.###
#.#...#.....#.#.#.#...#...#
###.#.#####.###.#.#########
#.#.#.....#...#.#.........#
#########.#.#.#.#.#.#######
#.......#.#.#.#.#.#.......#
#.#######.#.#########.###.#
#.......#.#.........#...#.#
###########################
