###########################
#.......#.#.#.....#.......#
###.#.#.#.#.#.#####.#.#.#.#
#...#.#.....#.....#.#.#.#.#
#####.#####.#####.#.#.###.#
#.#...#...#.#.......#...#.#
#.#.#.#.###.#######.#####.#
#...#.#...#.....#.......#.#
#.#.###.#.###.#.#####.###.#
#.#..E#.#.#.#.#...#.....#.#
#####.###.#.###.#.#.#.#.#.#
#.....#.#.#.....#.#.#.#.#.#
#.#.#.#.#.#####.#.###.#.#.#
#.#.#.#.........#.....#.#S#
###########################
