###########################
#E........................#
###.#####.###.#.#.###.###.#
#.#.....#...#.#.#...#...#.#
###.#####.###.###.#.#.#.#.#
#.#.....#...#...#.#.#S#.#.#
###.#.#.#.###.###########.#
#.#.#.#.#...#...........#.#
#####.#.###.#########.#.#.#
#...#.#...#.........#.#.#.#
###########################
