###########################
#.......#.......#S....#...#
#.#.###.###.#########.###.#
#.#...#.....#.......#.#...#
#.###.#####.#.###.#.#.#.#.#
#.#...#...#.#...#.#.#...#.#
#.#.###.#.#.###.#.#######.#
#.#...#.#...#...#.......#.#
#.###.#######.#######.###.#
#...#..............E#.....#
###########################
