###########################
#.....#...................#
###.###########.#########.#
#.....#...............#...#
#####.###.#####.#####.#.#.#
#.............#...#...#.#.#
#########.###.#############
#..E#.#...#...#.........#.#
#.###.#.#####.#.###.#.#.#.#
#.......#.........#.#.#...#
#.#.#.#####.###.###.###.###
#.#.#.....#...#...#..S#...#
###########################
