###########################
#..........E..............#
#.#.#######.#.#.#.###.###.#
#.#.......#.#.#.#...#...#.#
#.#.#########.###########.#
#S#.........#...........#.#
#.#.#########.#.#.###.#.###
#.#.........#.#.#...#.#...#
###.#####.#.#.###.#########
#.#.....#.#.#...#.........#
#.#.###.#.#.###.#####.#####
#.#...#.#.#...#.....#.....#
#.###.#########.#####.#.#.#
#...#.........#.....#.#.#.#
#.#.#.#.#.#####.###.#######
#.#.#.#.#.....#...#.......#
#######.#.#.###.#########.#
#.....#.#.#...#.........#.#
###########################
