###########################
#.#...#.........#...#...#.#
#.#.#.#####.###.#.#.#.#.#.#
#.#.#.......#.#.#.#...#.#.#
#.#.#########.#.#.#####.#.#
#.#.......#.....#.#...#.#.#
#.#######.#.#####.#.###.#.#
#.....#S..#.#.....#...#.#.#
#.#########.#.#######.#.#.#
#.#.......#...#.......#...#
#.#.###.#######.#########.#
#.#...#.......#.....#...#E#
#.###.#####.#.#####.#.#.#.#
#...#.#.....#.......#.#...#
#.#.#.#.#############.#####
#.#...#...................#
###########################
