###########################
#.....................#...#
#############.#######.###.#
#.............#.#...#...#.#
#.#############.#.#.###.#.#
#...........#...#.#.....#.#
#.#########.#.###.#####.#.#
#.....#.....#.......#S#...#
#####.#.###.#########.###.#
#.#...#...#.#.........#...#
#.#.#####.###.#########.###
#.#E..#.#...#.#.#...#...#.#
#.###.#.###.#.#.#.#.#.###.#
#.........#...#...#.......#
###########################
