###########################
#................E........#
#########.###.#.#.#.#####.#
#.......#...#...#.#.....#.#
#######.#.#.#.#.#.#.#.#.#.#
#.....#.#.#.#.#.#.#.#.#.#.#
#.#####.#####.#.###.#######
#.....#.....#.#...#.......#
#.#####.###.#.#.#####.#####
#.....#...#.#.#.....#.....#
#####.#######.#.#####.###.#
#...#.......#.#.....#...#.#
#####.###.#.#.#.#.#.#######
#...#...#.#.#...#.#.......#
#######.#.#####.#########.#
#.....#.#......S........#.#
###########.#####.#######.#
#.........#.....#.......#.#
###########################
