###########################
#.........................#
#.#.#.#######.#.###.#.#.#.#
#.#.#.......#.#...#.#.#.#.#
#.#####.#.#.###########.###
#....................S#...#
#.###.#.#.#######.#####.###
#...#.#.#.......#.....#...#
#####.###.#########.###.#.#
#...#...#.........#...#.#.#
#.#.#.###########.#####.###
#.#.............#.....#...#
#.###.#.#################.#
#...#E#.................#.#
###########################
