###########################
#...#...............#.#...#
###.#.###.#.#####.###.###.#
#...#.#...#.#.......#.#...#
#.#.#########.#####.#.###.#
#.#.#.........#...........#
#.#######.###.#######.###.#
#.....#.....#.#...#.#.#.#.#
#.###.#.###.###.#.#.###.#.#
#E..#...#.......#.#.......#
#.###.#.#####.#.###########
#.#.#.#.#.....#...#......S#
#.#.#######.#########.#.###
#.........#...........#...#
###########################
