###########################
#.............#...........#
#####.###.###.###.###.#.#.#
#.#S..#.....#...#.#.#.#E#.#
#.#####.###.#.###.#.#.###.#
#.#...#.#...#...#...#...#.#
#.###.#.#####.#.###.#######
#...#.#.#.#.#.#...#.#.#...#
###.#.#.#.#.#.#.###.#.###.#
#.#...#.#.#.#.#...........#
#.#.###.#.#.#########.###.#
#.......#...............#.#
###########################
