###########################
#.#.....#........S#...#...#
#.#.#.###.#########.###.#.#
#.#.#.....#...#...#.....#.#
#.#.#######.#.###.#.#####.#
#.#.........#...#...#.#E..#
#.#############.###.#.#.###
#...#.........#...#...#...#
#.#.#.#####.#####.#######.#
#.#.......#...............#
###########################
