###########################
#........E....#...........#
#.#########.###.#########.#
#...#.....#.....#...#.....#
###.###.#####.###.#.#.###.#
#S#.....#...#...#.#.#.#...#
#.#######.#.#####.#.#.###.#
#.....#...#.......#.#...#.#
#####.#.###########.###.#.#
#...#.#...........#.....#.#
#.###.#####.#####.#######.#
#.#...#...#.#.....#...#...#
#.#.###.#.###.#####.###.###
#.......#.....#...........#
###########################
