###########################
#.........................#
#.#.###.#.###.#.###.#.#####
#.#...#.#...#.#...#.#.....#
#.#####.#.#.###.#.#.###.#.#
#.....#.#.#...#.#.#...#.#.#
#.#########.#.#.#.#.#.###.#
#.........#.#.#.#.#.#...#S#
#.###########.###.###.#.#.#
#...........#...#...#.#.#.#
###.#######.#.###.#.#####.#
#.#.......#.#...#.#.....#.#
#####.###.#.#######.#.#.#.#
#...#...#.#E......#.#.#.#.#
###.#################.###.#
#.#.................#...#.#
###########################
