###########################
#.....#.#.................#
#.###.#.#.#########.###.###
#...#.#...#.#...#.#...#.#.#
#####.###.#.###.#.#####.#.#
#...#.#.......#.......#...#
###.#.#####.#.#.#.#####.#.#
#...........#...#...#.#.#S#
#######.#.#.#######.#.#####
#.#.....#.#.#.#...#.#.....#
#.#.#####.###.###.#.#.#.###
#...#...#.#...#...#...#...#
#.#####.###.#.#.###.###.###
#....E......#.#.....#.#...#
#.#.###########.#.###.#.###
#.#.....#.......#.....#...#
###########################
