###########################
#...........#...#.........#
#.#########.###.#.#######.#
#.#.....#...#...#.#..S#.#.#
#.#.###.#.###.#.#.#.###.#.#
#.....#.#.....#.#...#.....#
#######.#############.#####
#.......#...........#.....#
#.#.#####.#####.#########.#
#.#E#...#.....#...#.....#.#
#.###.#.#####.###.#.#.###.#
#.....#.........#...#.....#
###########################
