###########################
#..S#.....#...#...#.......#
#.###.###.#.#.#.#.#.#.###.#
#.....#...#.#...#.#.#...#.#
#######.###.#####.#####.###
#...#...#.....#.......#...#
###.#.#####.#.#######.#.#.#
#...#.....#.#...#.....#.#.#
#.#.#####.#####.###.#####.#
#.#...#...#...#...#.#.....#
#.#####.###.#.#.#.#.#.###.#
#.......#...#.#.#.#.#.#.#.#
#.#######.###.###.#.#.#.#.#
#.........#.......#..E#...#
###########################
