###########################
#....................E....#
#.#.#.#.#######.#.#.###.###
#.#.#.#.......#.#.#...#...#
#.###.#####.#.###.#.#.#.###
#...#.....#.#...#.#.#.#...#
#.#########.#.#.#.#.#####.#
#.........#.#.#.#.#.....#.#
#.#.#######.#.###.#####.#.#
#.#.......#.#...#.....#.#.#
#.#########.#.#.#.#.#######
#S........#.#.#.#.#.......#
###.#.#.#####.#.#######.#.#
#.#.#.#.....#.#.......#.#.#
#########.#########.#.###.#
#.......#.........#.#...#.#
###########################
