###########################
#.........................#
#.###.###.#.#######.#.#####
#...#...#.#.......#.#.....#
#.###.#.#.#.#####.###.#.#.#
#...#.#.#.#.....#...#.#.#.#
###.###########.#.#.#.#.#.#
#.#...........#.#.#E#.#.#.#
###.#.#.#.#.#.#.###.#######
#.#.#.#.#.#.#.#...#.......#
#.#.#.#.#.#####.#.#.#.#####
#.#.#.#.#.....#.#.#.#.....#
#.###.#.#.###.#.###.#.#.###
#...#S#.#...#.#...#.#.#...#
###########################
