###########################
#.....#...#...#.......#...#
#.#######.###.#.#.#######.#
#.....#.....#...#.#.......#
###.#.#.#.###.#.#.#.#.#.###
#.#.#...#.....#.#.#.#.#...#
#.#.#.#.###.#.###.#.###.###
#...#S#.#.#.#.#E......#.#.#
###.#####.###.#.#######.#.#
#.........#...#.#.........#
###########################
