###########################
#.........................#
#.#.#.#.#.#####.###.###.###
#.#.#.#.#.....#...#...#...#
#########.#######.###.###.#
#.......#.......#...#...#.#
###.#########.#######.#.###
#.#........S.........E#...#
#.#.###.#.###.###.#####.###
#.#...#.#...#...#.....#...#
###########################
