###########################
#.#.........#.............#
#.###.###.#.#####.#.#.###.#
#...#...#.#.......#.#...#.#
###.#.#.#############.###.#
#...#.#.#...#...#.....#...#
#.#.###.#.#.#.###.#####.###
#.#.......#.#.#...#...#...#
#.#.###.#####.#.###.#.#.###
#.#...#.#.#.....#.#.#.#.#S#
#.###.#.#.#####.#.#.#.###.#
#.#...#.#E....#.....#.....#
#.###########.###.#.###.#.#
#.....#...........#.#...#.#
###########################
