###########################
#.#.....#.#...#...#S#.....#
#.###.###.###.###.#.#.#.###
#.#.....#.#.........#.#...#
#.#.#.#.#.#.#.#######.#####
#.#.#.#.....#.....#.#.....#
#.###########.#.###.###.#.#
#.....#...#...#.......#.#.#
#.#######.#####.###.###.#.#
#.......#...#...#...#...#.#
#.#####.#.###.###.###.#####
#.#.#...#.#.#.#.......#.#.#
#.#.###.#.#.###.###.#.#.#.#
#.#.....#.#.....#.#.#.....#
###.###.#.#######.#######.#
#.#.#...#.#..............E#
#.#.#.###.#.#####.###.###.#
#...#.........#.....#...#.#
###########################
