###########################
#.....#...#...#.......#...#
#.#######.###.#.#########.#
#.........#.#.#...#...#.#.#
#.#######.#.#.#.#.#.###.#.#
#.......#.#.....#.#.#.#...#
#.#.#.#.#######.#.#.#.#.#.#
#.#.#.#.........#.......#.#
#######.#.#########.#.###.#
#.....#.#.#.........#...#.#
#.#.#######.#######.#.#.###
#.#...#.........#...#.#..S#
###.###.###########.#######
#.......#.......#.#.......#
###.###.#####.###.#.#.#####
#...#.....#.#.......#.#...#
#.#.#.#.###.#.#####.#.###.#
#.#.#.#.....#...#E..#.....#
###########################
