###########################
#S......#...#.#.#......E..#
#######.#.###.#.#.#.###.#.#
#.........#.#...#.#.#.#.#.#
###.#####.#.###.###.#.###.#
#...#...#.......#.#.#...#.#
#######.#.###.###.#.#.#.#.#
#.#.......#...#.#.#...#.#.#
#.#######.###.#.#.###.###.#
#.#.....#...#.#.#...#.#...#
#.#.###.###.#.#.#.#.#####.#
#.....#...#.#.#...#.#.....#
#.#####.###.###.#.###.#.#.#
#.....#.#.......#...#.#.#.#
#.#.###########.###.#.#.###
#.#.....#.....#.#.....#...#
#.###.#####.#.#####.#.###.#
#.#.........#.......#...#.#
###########################
