###########################
#.....#...#.....#.........#
#.###.#.#.###.#.#.#######.#
#...#.#.#...#.#.#.......#.#
#.#.#.#.###.###.#.#######.#
#.#.#...#.#...#...#.....#.#
###.#####.###.###.#.###.#.#
#...#E......#...#.#.#.#.#.#
#.###.#####.###.###.#.#.#.#
#...#.....#.........#.#...#
###.#######.#########.###.#
#...#.....#...#.....#.#...#
#.###.###.#.###.###.#.#.###
#...#.#...#.#...#...#...#.#
###.#.#.###.#.###.###.###.#
#...#.#...#.#.#.#...#.#...#
#.###.###.###.#.###.#.###.#
#.......#.........#S#.....#
###########################
