###########################
#S#.#...........#.........#
#.#.#.###.###.#######.###.#
#...#.#.#.#.......#.....#.#
#.#####.#.#########.#####.#
#.#...........#...#...#.#.#
#.#.#.#####.###.#.###.#.###
#...#.....#.....#.....#...#
#.###########.#.###.#.###.#
#.#.....#...#.#...#.#.....#
###.#.###.###########.###.#
#...#...#.#.#.#.#E..#...#.#
#.#####.#.#.#.#.###.#.#####
#.....#.....#...#.#.......#
#####.#.#####.###.###.###.#
#...#.#.#.......#.......#.#
#.#.#.#######.###########.#
#.#.#.....#.......#...#...#
#.#.#.#####.#####.###.###.#
#.#.............#.........#
###########################
