###########################
#.........................#
#.#.#######.#####.###.#####
#.#.......#.....#...#.....#
#.#####.###.#####.#.###.#.#
#.....#...#.....#.#...#.#.#
#.###.#.###.#####.#########
#...#.#...#.....#.........#
#.#######.#######.#######.#
#.......#E......#.......#.#
#.###.###.###.#####.#.###.#
#...#...#...#.....#.#...#.#
#.#.###.###.#.#.#.#.#####.#
#.#...#...#.#.#.#.#.....#.#
#.#.#.#.#.#.###.#.#.#.#.###
#.#.#.#.#.#...#.#.#.#.#...#
#.#.#####.#####.#####.###.#
#.#.....#.....#.....#..S#.#
#.#.#.#.#.###.#######.###.#
#.#.#.#.#...#.......#...#.#
###########.#.#########.#.#
#.........#.#.........#.#.#
#############.#########.#.#
#...........#.........#.#.#
###.#.#####.###.#.###.#.#.#
#.#.#.....#...#.#...#.#.#.#
#######.#.#####.#.###.#.#.#
#.....#.#.....#.#...#.#.#.#
###########################
