###########################
#.........#...#...........#
#.###.###.#.#.#.#######.###
#...#...#.#.#.#.#.....#...#
#.#####.#.#.#.#.#.###.###.#
#.#.....#.#.#.#.#.#.......#
#.#.#####.#.#.###.#.#######
#.#...#.....#.....#.#.....#
#####.###############.###.#
#.....#...............#...#
#.#####.###############.###
#.#.....#.....#.......#...#
#.#.#######.###.###.#.###.#
#.#.#.....#.#...#...#.#...#
#.#.#.###.#.#.###.###.#.#.#
#.#...#...#.....#.#...#.#.#
#.#####.#####.###.#.###.###
#.....#.#...#.#...#.#.#...#
#.#####.#.#.###.###.#.###.#
#.....#...#...#.#...#...#.#
#.###.#######.#.#.###.#.#.#
#...#.......#.#.#.....#.#.#
###.#####.#.#.#.#####.###.#
#E#.#...#.#.#.#.#.....#...#
#.#.###.#.###.#.#.#####.#.#
#.......#.......#...#S..#.#
###########################
