###########################
#..................S......#
###.#.###############.#.#.#
#.#.#..E............#.#.#.#
#.###.#.#.#######.#.#.#.###
#...#.#.#.......#.#.#.#...#
#.#####.#######.#.#####.###
#.....#.......#.#.....#...#
#.###.###.###.#####.###.#.#
#...#...#...#.....#...#.#.#
#.###.#.#.#.###.#######.#.#
#...#.#.#.#...#.......#.#.#
#.#########.###.###.#.#####
#.........#...#...#.#.....#
#.#########.#.#.#.###.#.###
#.........#.#.#.#...#.#...#
###.#.###.#.###.#.###.#.###
#.#.#...#.#...#.#...#.#...#
#.#######.#.#######.#####.#
#.......#.#.......#.....#.#
###########################
