###########################
#E..#.......#.....#.#.#...#
#.#.###.#.#.###.#.#.#.###.#
#.#...#.#.#.#.#.#...#.....#
###.#####.#.#.#####.#.###.#
#.#.....#.#.....#.....#...#
#.#.#####.###.###.###.#.###
#...#.#.....#...#...#.#...#
###.#.#.#####.#######.#.#.#
#.......#...#.#.......#.#.#
###.#.#.###.###.#.###.###.#
#.#.#.#...#.#...#...#.#.#.#
#.###.#.###.#####.#####.###
#.#...#.....#.......#.#...#
#.###.#.###.#.#######.#.#.#
#.....#...#...#...#...#.#.#
#.#######.#.###.#.#.#####.#
#.#...#.#.#.#...#.#.......#
#.###.#.#.#.#.#####.#####.#
#S#.......#.............#.#
###########################
