###########################
#...#..S#.....#.#.....#...#
#.###.#####.###.#####.#.#.#
#...#.....#.............#.#
###.#.###.#.#####.#.#.#.###
#.......#.#.....#.#.#.#.#.#
#######.#####.#####.#####.#
#...#.#...#.#...#.........#
#.###.#.###.###.###.#.#####
#.............#.#...#.#...#
#######.#.###.###.#####.###
#.#E..#.#.#.#.....#...#...#
#.#.#.#.###.#########.#.###
#...#...#...#.#.#.......#.#
###.#.###.###.#.###.###.#.#
#.#.#.....#.......#.#.#...#
#.#######.#######.#.#.#####
#...............#...#.#.#.#
#.###.###########.#.#.#.#.#
#.#...............#.......#
###########################
