###########################
#.........................#
#.#.###############.#.#.###
#.#....S..........#.#.#...#
###.#####.#.#.#####.###.###
#.#.....#.#.#.....#...#...#
#.#####.#####.###.#####.###
#.....#.....#...#.....#...#
#.#.#.#.###.#.#########.###
#.#.#.#...#.#.........#...#
###.###.###.#.#.###.#.#####
#.#...#...#.#.#...#.#.....#
#.#.#.#.#.#.#.#####.#.###.#
#.#.#.#.#.#.#.....#E#...#.#
#.###.###.#.#.#############
#...#...#.#.#.............#
###.#.###.#.#.#.#.#########
#.#.#...#.#.#.#.#.........#
#.#####.###.#.###.#.#.###.#
#.....#...#.#...#.#.#...#.#
#.#########.#.#.#####.#.###
#.........#.#.#.....#.#...#
###.###.#####.#####.#####.#
#.#...#.....#.....#.....#.#
###.#.#.###.#.#####.###.###
#.#.#.#...#.#.....#...#...#
#.#.#.#.#####.#######.#.###
#.#.#.#.....#.......#.#...#
###########################
