###########################
#S#.#.........#.....#.#...#
#.#.#########.#.###.#.#.#.#
#.#.#.#...........#.....#.#
#.#.#.#.#.###########.#.#.#
#...#...#.......#.#...#.#.#
###.###.#.###.#.#.#####.###
#...#.#.#...#.#.......#...#
###.#.###.#######.#####.###
#.#.#...#.#.........#.#...#
#.#.###.###.#.#######.###.#
#...#.......#...#.#.....#.#
###.#######.#####.###.###.#
#.........#.#...#.....#.#.#
#.###.#.#.###.#.#.###.#.#.#
#...#.#.#.#.#.#.....#.#.#.#
###.###.###.###.#.#####.#.#
#.....#.#...#.#.#.#.......#
###.#.#####.#.#.###.###.###
#...#....E..#.......#.....#
#.#.#######.#.###.#######.#
#.#.....#...#...#.......#.#
#.#.#.#.#####.#.#.#####.###
#.#.#.#.......#.#.#.......#
###########################
