###########################
#.........................#
#######.#.###############.#
#.....#.#...............#.#
###.#####.###.#######.###.#
#.#.....#...#.......#...#.#
#####.#.#.#.#####.###.#.###
#...#.#.#.#.....#...#.#...#
#.#.###.#.#.#.#.#.#.#.#####
#.#...#.#.#.#.#E#.#.#.....#
#.#####.###.#.#.###########
#.....#...#.#.#...........#
#.###.###.#####.###.#.#.###
#...#...#.....#...#.#.#...#
#.#.#.###.#####.#.###.###.#
#.#.#...#.....#.#...#...#.#
###.#.###.#.#.#.###.#.#####
#.#.#...#.#.#.#...#.#.....#
#.#.#.#.#####.#.###.#.###.#
#.#.#.#.....#.#...#.#S..#.#
#######.###.#.#.#####.###.#
#.....#...#.#.#.....#...#.#
###.#.#########.#####.#.###
#.#.#.........#.....#.#...#
#####.#####.###.#####.#.###
#...#.....#...#.....#.#...#
###########################
