###########################
#.........................#
###.#.#.#.#.#.#.###.#.#.#.#
#.#.#.#.#.#.#.#...#.#.#.#.#
#.#.###.#.#.#.#.#.#.#.#####
#.#...#.#.#.#.#.#.#.#.....#
###.#.#####.#.###.#########
#.#.#.....#.#...#.........#
#.#.#.#.###########.#######
#.#.#.#...........#.......#
###.#.###.###.#.#########.#
#S......#...#.#.........#.#
#####.#.#.#####.#.#######.#
#.....#.#.....#.#.......#.#
#.#.#.#####.#.#############
#.#.#.....#.#.............#
#.###.#.#.#.#.###.###.###.#
#...#.#.#.#.#...#...#...#.#
#.#.#.#######.#.#.#.#.###.#
#.#.#.......#.#.#.#.#...#.#
###.#.#####.#.###.#.#######
#.#.#.....#.#...#.#.......#
#.#.#.#.#####.#.###.#.#####
#.#.#E#.....#.#...#.#.....#
#####.#####.#.###.#.#.#####
#...#.....#.#...#.#.#.....#
###########################
