###########################
#..............S..........#
#.###.#.###.###.###.#.#.#.#
#...#.#...#...#...#.#.#.#.#
#######.#.#######.#.#.#.###
#.....#.#.......#.#...#...#
###.#.#.#.###.#####.#.#.#.#
#.#.#.#.#...#.....#.#.#.#.#
#.###.#####.#.#####.#.#####
#...#.....#.#.....#.......#
#.#.#.#############.#.#.#.#
#.#.#.............#.#.#.#.#
#.###.#####.###.###.#.###.#
#...#.....#...#...#.#...#.#
#.#.#####.#.#.#.#####.###.#
#.#.....#.#.#.#.........#.#
###.#.#.#.###.###.###.#.###
#.#.#.#.#...#...#...#.#...#
#.#####.###.#######.#.#####
#.....#...#.......#.......#
#.###########.###.###.#.###
#...........#...#...#E#...#
#.###.#.###.#.###.#.#.###.#
#...#.#...#.#...#.#.#...#.#
###########################
