###########################
#.......#.............#...#
#.#.###.#####.#######.#.#.#
#.#.#S#.....#...#...#...#.#
###.#.#####.###.###.#####.#
#...#.#...#...#.......#.#.#
#.###.#.#.###.#######.#.#.#
#.....#.#.#...#.........#.#
#######.#.#.#############.#
#.......#.#.#.............#
#.#####.###.#.###########.#
#.#...#...#...#...#.......#
###.#.###.#######.#.#######
#...#.....#.......#.....#.#
#.#######.#.#.#########.#.#
#.#.#.......#.#.........#.#
#.#.#.#########.#########.#
#.#.#.....#...#.#.#.......#
#.#.#.#####.#.#.#.#.#.###.#
#.#...#...#.#...#...#.#.#E#
#.#####.#.#.#########.#.#.#
#.......#.............#...#
###########################
