###########################
#.........................#
###.#.#####.#.#.#.#######.#
#.#E........#.#.#.......#.#
#######.#.#.#.#.###.###.###
#.....#.#...#.#...#...#...#
###.#######.#######.###.###
#.#.......#.......#...#...#
###.#####.#.#####.###.#.#.#
#.#.....#.......#...#.#.#.#
#.#.#.###.#.#.#.#.#.###.###
#.#.#...#.#.#.#.#.#...#...#
#######.#.#.#.###.###.###.#
#.....#.#.#S#...#...#...#.#
#######.#.###.#######.###.#
#.....#.#...#.......#...#.#
#.###.#.#.#########.#.#####
#...#.#.#.........#.#.....#
#.###.###.#.#####.###.###.#
#...#...#.#.....#...#...#.#
#.#.#.#.#####.#########.###
#.#.#.#.....#.........#...#
###########################
