###########################
#.........................#
###.#.###############.#.#.#
#.#.#..............E#.#.#.#
#.#.#.###.#.###.#####.#.###
#.#.#...#.#...#.....#.#...#
###.#.#.###.###.###.#.#.#.#
#.#.#.#...#...#...#.#.#.#.#
###.#.#.#.#######.#.###.#.#
#.#.#.#.#.......#.#...#.#.#
#####.#.###.#.#.#.###.#.###
#...#.#...#.#.#.#...#.#...#
#.###.#####.#####.#.#.#.#.#
#...#.....#.....#.#.#.#.#.#
###.#.###.#.#.#.###.###.###
#.#.#...#.#.#.#...#...#...#
#.#.#.#.#####.###.###.#.###
#.#.#.#.....#...#...#.#...#
###.#.#########.#.#.#######
#.#.#......S..#.#.#.......#
#####.#.###.###########.###
#...#.#...#...........#...#
#.#.#.#####.###.#.#.#.#####
#.#.#.....#...#.#.#.#.....#
#.#.#.#.#.#.#.#.#####.#.#.#
#.#.#.#.#.#.#.#.....#.#.#.#
#.#.###.###.#######.###.###
#.#...#...#.......#...#...#
###########################
