###########################
#.#...#...........#.......#
#.#.#.###.#.#####.#.#####.#
#...#...#.#.#...#.#...#...#
#.#####.#.#.#.###.###.###.#
#.#.....#.#.#...#...#...#.#
#.#.#####.#.###.###.#.#.#.#
#.#.#S#...#...#...#.#.#.#.#
#.#.#.#.#####.###.#.#.#.#.#
#.#...#.....#...#E..#.#.#.#
#.#######.#####.#.###.#.###
#...#.....#.....#...#.#...#
###.#.#####.#######.#####.#
#...#.....#.#.....#.....#.#
#.###.#####.#.###.#####.#.#
#.#...#...#...#...#...#.#.#
#.###.#.#.#####.###.###.#.#
#...#.#.#...#...#...#...#.#
###.###.###.#.###.#.#.###.#
#.#.....#.#.#...#.#.#.#...#
#.#######.#.###.#.#.#.#.#.#
#...............#.#.....#.#
###########################
