###########################
#.....#.........#.......#.#
#.#####.#######.#####.#.#.#
#.#.....#.#..S#.#.....#...#
#.#.#####.#.###.#.#######.#
#.#.#.....#.#...#.#.....#.#
#.#.#.#.###.#.#.#.#.#.#.#.#
#...#.#...#.#.#.#.#.#.#.#.#
#.###.###.#.###.#.###.#.#.#
#...#...#.#.#...#...#.#.#.#
###.#####.#.#.#####.#.###.#
#.#...#...#.#.#.....#...#.#
#.###.#.#.#.#.#.#######.#.#
#...#.#.#.#...#.#.......#.#
#.###.#.#.#####.###.###.#.#
#.#...#.#.#...#.#...#...#.#
#.#.###.#.#.#.#.#.#.#####.#
#.#.#...#...#E..#.#.#.....#
#.#.#.###########.###.#####
#.....#...................#
###########################
