###########################
#E........................#
#.#######.#.###.#######.#.#
#.......#.#...#.......#.#.#
#.###.###.#.#.#.###########
#...#.....#.#.#...........#
#####.###.#.###.#.#####.#.#
#...#...#.#...#.#.....#.#.#
#.#####.#.###.#.#.###.###.#
#.....#.....#.#.#...#...#.#
#.#.#####.#####.#.#.#.###.#
#.#...........#.#.#.#...#.#
#.###.###.#.#####.#.#.#####
#...#...#.#.....#.#.#.....#
#.#.#.###.#.#.#.#.#########
#.#.#.....#.#.#.#.........#
#.#####.#.###########.###.#
#.....#.............#...#.#
#######.#.#.###############
#.....#.#S#...............#
#.#.#####.#####.#####.#####
#.#.....#.....#.....#.....#
#########.###.###.#.#.#.###
#.......#...#...#.#.#.#...#
###.#.###.###.#.#.#.#.#.#.#
#.#.#...#...#.#.#.#.#.#.#.#
###########################
