###########################
#....E......#.#.#.#...#.#.#
#####.#######.#.#.#.###.#.#
#.......#...#...#.#.......#
#.#.#.#.#.#.#.#.#.#.#######
#.#.#.#.#.#.#.#...#.....#.#
###.###.#.#.#####.#.#.#.#.#
#.....#.#.#...#.....#.#...#
#.#.#####.#######.#.###.###
#.#.....#...#.#...#...#...#
#.###.#.#.###.#.#.###.#####
#.#...#.......#.#.#.#.#...#
#####.#######.###.#.#.#.#.#
#...#...#...#.#...#.#.#.#.#
#.###.###.#####.#.#.#.#.###
#.....#.....#...#.#.......#
#.###.###.###.#.#.#########
#...#.........#.#.#.....#.#
#.#####.###.###.#######.#.#
#.....#.#...#.........#.#.#
###.###########.###.###.#.#
#.#.#.#...........#.......#
#.###.###.###.#.#.#.#####.#
#..S#...#.#.#.#.#.#.#.#.#.#
#.###.#.#.#.#.#.#.###.#.###
#.#...#.#.#...#.#.#...#.#.#
#.###.#.#.###.#.#.#.###.#.#
#.....#.....#.#.#.........#
###########################
