###########################
#...#....S#...#...#.......#
#.#.###.###.#.#.#####.###.#
#.#.#.#.....#.#.#.#.....#.#
#.#.#.###.#####.#.###.#.#.#
#.#.#.#...#.........#.#.#.#
#.#.#.#.#####.###.#.#####.#
#.#.#.........#.#.#.#.....#
#.#####.#.#####.#.#.###.###
#.....#.#.#.#.....#.......#
###.#.#####.#.#########.###
#...#...#...........#.#...#
#####.#######.#####.#.#.###
#.....#...#...#.....#...#.#
#.#.#####.#######.#.###.#.#
#.#.#...#.....#...#.#.#...#
###.#.###.###.#####.#.#.#.#
#.#.#.....#...#...#.#.#.#.#
#.#.#.#########.#####.#.#.#
#.#...#.#.#.#...#.#...#.#.#
#.#.#.#.#.#.###.#.#.###.###
#.#.#.............#.#.#...#
#.###.#####.###.###.#.###.#
#.#.....#E#.#.........#...#
#.#.#.#.#.#########.#.#.###
#...#.#.....#.......#.....#
###########################
