###########################
#...............#.......#.#
#.#.#######.#####.#####.#.#
#.#...#.#...#.....#S..#.#.#
#.###.#.#.###.#######.#.#.#
#.#...#.....#.#...#...#.#.#
#.#.#######.#.#.#.#.###.#.#
#.#.......#.#...#...#...#.#
#.#######.#.#########.###.#
#.#.....#.#...#.....#.#...#
#.#.#.###.###.#.#####.#.#.#
#.#.#...#.#.....#...#...#.#
#.#.###.#.#####.#.#.#####.#
#E#.#.#.#...#...#.#...#...#
#.#.#.#.###.#####.###.#.###
#.#...#...#.....#.#.#...#.#
#.#######.#####.#.#.#####.#
#.#...........#.#.....#...#
#.#.#######.###.#####.#.###
#.#.#...#...#...#...#.#...#
#.#.###.#.###.###.#.#.#.#.#
#.#...#...#.#.....#...#.#.#
#.###.#.###.#############.#
#.#...#.#...#.....#.....#.#
#.#.###.#.#.###.#.#.###.#.#
#...#.....#.....#...#.....#
###########################
