###########################
#S#.....#...#.....#.......#
#.#####.###.#.#.###.#####.#
#.#.#.#.....#.#.......#.#.#
#.#.#.#.###.#.#########.#.#
#...#.....#.....#.#E..#...#
###.###.#########.#.###.###
#.....#.#.#...#.......#...#
#.###.###.###.#.#.#####.###
#.#...#.#.......#.#.....#.#
###.###.###.#####.###.#.#.#
#...#.....#...#.#...#.#.#.#
#.#######.#.#.#.#####.###.#
#.#...#.....#...#.....#.#.#
#.###.#########.#.###.#.#.#
#...........#.......#...#.#
###########.#####.#.#.###.#
#.#...#.....#...#.#.#...#.#
#.#.###.#######.#######.#.#
#.#...#.#...#.#.#...#.#...#
#.#.###.###.#.#.###.#.###.#
#.....#...........#.#.....#
#####.#.#######.###.#.#.###
#...#.#.#.......#.....#...#
###.#.#.###.###.#.#######.#
#.....#...#...#...#...#...#
#.#.###.###.#.#####.###.###
#.#.....#...#.........#...#
###########################
