###########################
#.....#...........#.......#
#.#.#.#.#########.###.###.#
#.#.#...#...#.......#.#...#
#.#.#####.#.#######.###.#.#
#.#.......#.....#...#...#.#
#.#############.#.###.###.#
#.#.#...#.......#.#...#...#
#.#.#.#.#.#######.###.#.###
#...#.#...#.......#...#...#
###.#.###.#######.#.#####.#
#...#.#...#.....#.#.#.....#
#####.#.###.###.#.#.#####.#
#.....#.#...#...#...#...#.#
#.#####.#.###.#######.#.###
#.#...#.#.#...#.....#.#...#
#.#.###.#.#.###.###.#.###.#
#.#.....#.#.....#...#.#...#
#.#######.#######.#.#.#.###
#.........#.......#.#.#...#
#.#########.#.#######.###.#
#..E..#...#.#.#.....#.#.#.#
#####.#.#.#.###.###.#.#.#.#
#...#...#.#.......#.#.#.#S#
#.#.#####.#########.#.#.###
#.#.....#...#...#...#.#...#
#.#####.###.#.#.#.###.#.#.#
#.....#.......#.#.......#.#
###########################
