###########################
#............S............#
#####.###.#.#.#.#.#.#####.#
#...#...#.#.#.#.#.#.......#
#.#.###.###.#####.#.#.###.#
#.#...#...#.....#.#.#...#.#
#.###.#########.#####.#.#.#
#...#.........#.....#.#.#.#
#######.#.#.#.###.###.#.#.#
#.....#.#.#.#...#...#.#...#
#######.#######.###.#.#.#.#
#.....#.......#...#.#.#...#
#######.#.#.#.#.#.#####.#.#
#.....#.#.#.#.#.#.....#.#.#
###.#.#.#######.#########.#
#.#.#.#.......#...........#
###.#.#######.###.###.###.#
#.#.#.......#...#...#.....#
###.#########.###.#####.#.#
#.#.........#...#.....#.#E#
#.#.###########.#.#########
#.#...........#.#.........#
#.###.#.###.#.###.###.###.#
#...#.#...#.#...#...#...#.#
###########################
