###########################
#.....#...#....E#.........#
#.#.#.#.###.###.#.#.#####.#
#.#.#...#...#.#...#...#...#
#.#.#####.###.#####.#.#.###
#.#.....#.#...#...#.#.#...#
#.#####.#.###.#.#.###.###.#
#.#...#.#...#.#.#...#...#.#
#.###.#.###.#.#.###.###.#.#
#.....#...#...#.#.......#.#
#####.###.###.#.#########.#
#...#...#.....#.........#.#
#.#.###.#############.#.###
#.#...#...#.........#.#...#
#.###.###.#.#######.#####.#
#.#...#...#.....#.#.......#
#.#.###.#######.#.#########
#.#...#...#S....#.......#.#
#.###.###.#######.#####.#.#
#.#.....#...#.........#...#
#.#.#######.#########.###.#
#.#...................#...#
###########################
