###########################
#.#.........#.........#...#
#.#.#.#######.#####.#.#.#.#
#.#.#...#...#.#...#.#.#.#.#
#.#.###.#.#.#.#.###.###.#.#
#...#...#.#.#.#...#.....#.#
#####.###.#.#.#.#.#######.#
#.....#...#...#.#.......#.#
#.#####.#######.###.###.#.#
#.....#...#.......#.#...#.#
#.###.###.#.#######.#.###.#
#...#.....#.#.......#...#.#
###.#########.#########.#.#
#.#.#.....#...#...#...#.#.#
#.#.#.###.#.#.#.#.#.#.###.#
#...#.#.#...#.#.#...#.....#
#.###.#.###.###.###########
#...#.#.....#S..#.....#...#
###.#.#.#########.###.###.#
#.#...#.#.........#.#...#.#
#.#####.#.#######.#.###.#.#
#.......#.#.....#.#...#...#
#.#########.###.#.#.#####.#
#E#...#.....#.#...#...#...#
#.#.#.#.#####.#####.#.#.###
#...#...#...........#.....#
###########################
