###########################
#.......#.................#
#.###.###.###########.###.#
#...#.....#.....#...#.#...#
#.#########.###.#.#.#.#.###
#.#..E..#...#...#.#...#...#
#.#.###.#.###.###.#######.#
#.#.#.#...#.#...#.#...#...#
###.#.#####.###.#.#.#.#####
#...#.....#...#.#...#.....#
#.###.###.#.#.#.#########.#
#.#.....#.#.#.#.#...#...#.#
#.#####.#.###.#.#.#.#.#.#.#
#.......#.....#S#.#.#.#...#
#############.###.#.#.#####
#.........#.#.#...#.#.....#
#.#.#####.#.#.#.###.#####.#
#.#.....#...#.#...#.......#
#.#####.#####.#.#.#######.#
#...#.#.......#.#.....#.#.#
###.#.#########.#####.#.#.#
#...#.......#...#...#.#...#
#.#######.#.#####.#.#.#.###
#.........#.......#...#...#
###########################
