###########################
#...........#.............#
#.#####.###.###########.#.#
#.....#...#...#.....#E..#.#
#####.###.###.#.###.#.###.#
#...#.#.#...#...#...#.#...#
#.#.#.#.###.#####.###.#.###
#.#.#...#...#.........#...#
#.#####.#.###############.#
#.....#.#...#S#.....#.....#
#.#.###.###.#.#.###.###.###
#.#.#...#...#...#.#...#...#
#.#.#.###.#######.###.#####
#.#...#.#.....#.....#.....#
#.#####.###.###.#.#######.#
#...#.....#.....#.......#.#
###.#####.###########.###.#
#.#.#.........#.....#.....#
#.#.#.#######.#.###.#######
#.....#.........#.........#
###########################
