###########################
#.........................#
#.#.###.#####.###.#.#.#.###
#.#...#.....#...#.#.#.#...#
#.#####.###.#.###.#.#.#.###
#.....#...#.#E..#.#.#.#...#
#.#######.#.###.#.#.#.#####
#.......#.#...#.#.#.#.....#
#######.#######.###.#######
#.....#.......#...#.......#
###.#.#.#.#.#####.#.#######
#.#.#.#.#.#.....#.#.......#
#.###.###.###.#.#.#.#.#.###
#...#...#...#.#.#.#.#.#...#
#.#.###.#.#.#.#.###.#.#.#.#
#.#...#.#.#.#.#...#S#.#.#.#
###.#.#.#.#.#.#.#####.#.#.#
#.#.#.#.#.#.#.#.....#.#.#.#
###.#.#.###.###.#.#####.###
#.#.#.#...#...#.#.....#...#
###########################
