###########################
#.........#.#.....#.......#
###.#####.#.#.#.#.#.###.###
#...#.....#...#.#.#E..#...#
#.###.#########.#####.###.#
#...#.#.......#.......#...#
###.#.###.###.###.#####.###
#...#.....#.#...#.....#...#
#.#.#######.###.#########.#
#.#.#...#.....#.#...#...#.#
#.###.#.###.###.#.#.#.#.#.#
#.....#...#...#...#...#...#
#.#######.###.###########.#
#.#.....#.#.......#.......#
#.#.###.#.#.#######.#######
#...#.#.#.#.......#.#.....#
#####.#.#.#####.#.#.###.#.#
#...#...#.....#.#.#.#...#.#
#.#.#.#######.###.#.#.###.#
#.#...#.......#...#...#.#.#
#####.#.#######.#######.#.#
#S..#.#.#...............#.#
###.###.#.#########.#####.#
#.#...#.#.....#.....#.....#
#.###.#.#####.#.#####.#####
#...#...#...#.#.#.....#...#
#.#######.#.#.#.#.#####.#.#
#.........#...#.........#.#
###########################
