###########################
#...#...#.#...#...#.......#
###.###.#.###.#.#.#.###.###
#.....#.......#.#...#...#.#
###.#######.#.###.#.#####.#
#...#...#.#S#.#.#.#.#.....#
#.###.#.#.###.#.#.###.###.#
#...#.#.#.....#...#.#.#...#
#.###.#.#####.#.###.#.#.#.#
#.#.#.#.........#.#.#.#.#.#
#.#.#######.###.#.#.#####.#
#.......#.....#.#...#.....#
#.#####.#.#####.#.#####.#.#
#...#...#...#.....#.#.#.#.#
#.#####.###.#.#.###.#.###.#
#...#.#...#.#.#.#.....#.#.#
#.###.###.#.#########.#.#.#
#...#...#.............#...#
###.#.###.#.#.###.#.#.###.#
#.....#...#.#.#...#.#...#.#
#.#.#####################.#
#.#.......................#
#.###.###.#######.###.#####
#...#...#.#...#...#.#.#...#
#.#.#.#.###.###.###.#.#.#.#
#.#.#.#...#.....#.#.#...#.#
###.#######.#.###.#.#####.#
#E........#.#...........#.#
###########################
