###########################
#S#.....................#.#
#.#########.###.#.#.#.#.#.#
#.#...#.....#.#.#E#.#.#...#
#.###.#.###.#.#.#######.###
#.#.....#...#.#.....#.#.#.#
#.###.#.#####.#.###.#.###.#
#.#...#.#.#.#.#.#.........#
#.#.#.###.#.#.#.#####.###.#
#.#.#.#.#.....#.#.#.....#.#
#.###.#.#.#######.#.#######
#.#...#.......#...#.#.#...#
#.###.#######.#.#.###.#.#.#
#.......#.....#.#.......#.#
###.###.#.#.#.###.#.###.#.#
#...#.#.#.#.#.#...#...#.#.#
#.###.#.#####.#####.#####.#
#.#...#...#.#.#.#.#.#...#.#
###.###.#.#.#.#.#.#.#.###.#
#.......#.........#.....#.#
#####.###########.###.#.###
#.....#...............#...#
###########################
