###########################
#.....#.#...............#.#
#.###.#.#.#########.###.#.#
#.#...#.#...#.#...#.#...#.#
#.###.#.###.#.#.#.#.#.###.#
#...#...#...#.#.#...#...#.#
#.#.###.#.###.#.#######.#.#
#.#.#...#.#...#.......#.#.#
###.#####.#.#.#####.#.#.#.#
#...#.....#.#.#...#.#.#.#.#
#.#.#.#####.#.#.#.###.#.#.#
#.#.#.......#.#.#.....#.#.#
#.###########.#.#######.#.#
#.....#..E....#.#...#.#.#.#
#.###.#.#######.#.#.#.#.#.#
#...#.#.#.....#.#.#.#...#.#
#####.#.###.#.#.#.#.#.###.#
#.....#.....#.#...#.#...#.#
#.###.#######.#####.###.#.#
#...#.#.....#.#.#...#...#.#
#.#.###.###.#.#.#.###.###.#
#.#...#.#.#.....#.#.#...#.#
#.###.#.#.#######.#.###.#.#
#...#.........#S..#.......#
###########################
