###########################
#...#.........#...#...#..S#
#.#.#.#.#.###.#.#.###.#.###
#.#...#.#.#.#.#.#...#.....#
###.#.###.#.#####.#####.#.#
#.#.#.#.............#...#.#
#.#.###.#####.#######.###.#
#.....#.#...#...#.....#...#
#.###.#.#.###.###.###.#####
#.#...#..E#.....#.#.......#
#####.###############.#.###
#...........#.....#.#.#...#
###########.#.#.###.#####.#
#.........#...#.#...#.#...#
###.###.#.#.###.#.###.#.###
#.#.#.#.#.#.#.....#.....#.#
#.#.#.#####.#####.#.#.###.#
#.#.#.#...#.....#.#.#.....#
#.#.#.###.#.###.###.#.#.###
#.......#.....#.....#.#...#
###.###########.###.###.#.#
#...#...#...#.....#...#.#.#
#.###.###.#.#########.#.###
#.......#.#...........#.#.#
###.#.#.#.###.#########.#.#
#...#.#...#...#...........#
###########################
