###########################
#..................S......#
#.###.#######.###########.#
#...........#...........#.#
#####.###.#.#.###########.#
#.......#.#.#...........#.#
#####.#######.#####.#.#.###
#...#.......#.....#.#.#...#
#.###.#.#.#.###.#.#.#.#####
#.....#.#.#...#.#.#.#.....#
#.#.#.#.###.#####.#.#.###.#
#.#.#.#...#.....#.#.#...#.#
###.#.###.###.#.#####.###.#
#.#.#...#...#.#.....#...#.#
#.#.#.#.#.#.#.#####.#.#.###
#.#...#.#.#.#.....#.#.#...#
#####.#.###.###.#.#####.###
#.....#...#...#.#.....#...#
###.#.###.#####.###.#.###.#
#.#.#E..#.....#...#.#...#.#
#.#.###.#.#####.#########.#
#.#...#.#.....#.........#.#
###########################
