###########################
#.......#.....#.........#.#
#.###.#.###.#####.###.###.#
#...#.#.......#...#.#.....#
#.#######.#.#.#.#.#.#.###.#
#...#.#.#.#.#...#.#.....#.#
###.#.#.#####.#.###.#.#.###
#.#...#.#.#.#.#.#.#.#.#.#.#
#.#.###.#.#.#####.#.#.#.#.#
#.#...#...........#.#.#...#
#.#.#####.###.#.#.#.#######
#.......#.#E#.#.#.#.......#
###.#######.#.###.###.#####
#.....#.#.......#.#.....#.#
#.###.#.#.#.#########.###.#
#...#...#.#...#.....#.#...#
#.#.###.#.###.###.#####.###
#.#.#.#...#.#.........#...#
#.###.###.#.#######.#####.#
#.#...#.....#.....#.......#
#####.#.#.#.###.#####.#.#.#
#.#.#...#.#.#.......#.#.#.#
#.#.###.#####.#####.#.#####
#.......#.....#..........S#
###########################
