###########################
#...#.......#.#.#.#...#...#
#.###.###.###.#.#.###.#.###
#.....#.............#.....#
#.#.#####.#######.#.#.#.#.#
#.#.#.....#.....#.#...#.#.#
#########.###.#######.#.#.#
#.#S#.....#.....#.....#.#.#
#.#.#.#####.#####.#.###.###
#.....#...#...#.#.#.#.#...#
#########.#.#.#.###.#.###.#
#.#.#...#...#.......#...#.#
#.#.###.#.#.#########.###.#
#.#.......#.#...#...#E#...#
#.#.#.#.###.#.#.###.#.#.#.#
#...#.#.#...#.#.......#.#.#
#####.#######.###########.#
#.....#.........#.....#.#.#
#####.#.#.#########.###.#.#
#.......#...#.......#.....#
###.#.#.#######.###.#####.#
#...#.#.....#...#.........#
###########################
