###########################
#.........#...#...........#
#######.###.#.#.###.#####.#
#.......#...#.....#.....#.#
#.#####.#.#######.#####.#.#
#...#...#.#...#...#.....#.#
###.#####.#.#.#####.#####.#
#...#...#.#.#.....#...#...#
#.###.#.#.#.#####.#.#.#.###
#...#.#...#.#.....#.#.#...#
#.#.#.#####.#####.#.#.###.#
#.#...#...#.....#.#.#.#...#
#.#####.#######.#.###.#####
#.#.......#.....#...#.....#
#.#######.#.#######.###.#.#
#E..#...#.#.#.........#.#.#
###.#.#.#.#.#.#######.#.#.#
#...#.#.#.#.#.#..S#...#.#.#
#.###.#.#.#.#.#.###.###.#.#
#.#...#.#.#.#.#.#...#...#.#
#.#.###.#.#.#.#.###.#####.#
#.#.#.#.#.#.#.#...#.......#
#.#.#.#.#.#.#####.#######.#
#...#.....#.......#.......#
###########################
