###########################
#........S#.#...#.....#.#.#
#.#.###.###.#.#.#.#####.#.#
#.#.#.....#...#.#.......#.#
###.###.###.###.#.###.#.#.#
#.....#.#...#.#...#...#...#
###.#####.###.#.#####.###.#
#.#.....#...#...#.#.#.#.#.#
#.#.#.###.#.###.#.#.#.#.#.#
#.#.#.#...#...#.#.#...#...#
#.#.#.#######.###.#.###.###
#...#.#...#.#E#...#.#...#.#
###.#.#.#.#.#.###.#.#.###.#
#...#.#.#.......#.#.#.....#
#.#.#####.###.###.#########
#.#...#.#...#...#.#.#...#.#
#.#.###.#.#######.#.#.###.#
#.#.....#...#.......#...#.#
#.###.#.###.#.#####.###.#.#
#.#...#...#.#.#...#...#.#.#
#.#######.#.###.#.#.#.#.#.#
#.....#.........#...#.....#
###########################
