###########################
#...................#.....#
#.###.#############.#.###.#
#.#...#...#.......#...#...#
#.#####.#.#######.#####.###
#...#...#.......#.....#.#.#
#.#.#.#.#######.###.###.#.#
#.#.#.#.#S#...#...#.......#
#.#.#.###.#.#.###.#######.#
#.#.#.....#.#...#.....#...#
#.#.#######.#########.#.###
#.#.......#.........#.#...#
#.#.#.#####.###.###.#.###.#
#.#.#.#.....#...#...#.#...#
#.#.###.#####.###.###.###.#
#.#...#.#...#.#.....#...#.#
#####.#.#.#.#.###.#####.###
#.....#.#.#.#...#.#...#..E#
#.#####.###.###.###.#.###.#
#.............#.....#.....#
###########################
