###########################
#...#.............#.......#
#.#.#.#######.###.#.#.#####
#.#...#.....#.#.#.#.#.....#
#.#########.#.#.#.#######.#
#.....#.....#.#...#.....#.#
#####.#.###.#.#.###.###.#.#
#...#.#..E#.#.#.....#.#.#.#
#.###.###.#.#.#######.#.#.#
#...#.#...#.#...#.....#...#
#.#.#.#.#.#####.#.#######.#
#.#...#.#.#.....#.....#...#
#####.#.###.#####.###.#.###
#...#.#.#...#.......#...#.#
#.#.#.#.#.#########.#####.#
#.#.#...#.......#.#.#.....#
#.#.###########.#.#.#.#.###
#.#.............#.#.#.#...#
#.###############.#.#.###.#
#...#.....#.........#...#.#
###.#.###.#.#######.#####.#
#...#...#...#....S#...#...#
#.#######.###.#######.#.#.#
#.......#.#...#...#...#.#.#
#.#####.#.#.###.#.#.###.###
#.....#.#.#.#.#.#...#.....#
#####.#.###.#.#.#####.###.#
#...#.#...#.#.#...#.....#.#
#.#.#.###.#.#.###.#######.#
#.#.....#...#.............#
###########################
