###########################
#...............#.........#
#######.#.#####.#####.###.#
#.....#.#.#...#.....#.#...#
#.###.###.#.#.#####.###.#.#
#.#.......#.#.....#.....#E#
#.#########.#.###########.#
#.#.....#...#.#.........#.#
#.#.###.#.#.###.#####.###.#
#.#...#.#.#...#.....#.....#
#.###.#.#.###.#####.#######
#.....#.#...#.....#.#.....#
#.#####.#####.###.#.#.###.#
#.#...#.....#...#.#.#.#...#
#.#.#.#####.#####.#.#.#.#.#
#.#.#.....#...#...#.#.#.#.#
#.#.#####.###.#.#.#.###.#.#
#...#...#...#.#.#.#.....#.#
###.#.#.###.#.#.#########.#
#...#.#.#...#.#.......#.#.#
#.###.#.#####.###.###.#.#.#
#...#.#...#...#...#.....#.#
###.#.###.#.###.#########.#
#...#.#.....#.#.....#.....#
#.###.#######.#.###.#.#####
#.#.#...#.........#.....#.#
#.#.###.#######.#######.#.#
#...#.#...#...#.#...#...#.#
###.#.###.#.#.###.#.###.#.#
#.......#...#.....#..S#...#
###########################
