###########################
#.........................#
#####.#####.###.#####.#####
#...#.....#...#.....#.....#
#####.###.#.#####.#.###.###
#...#...#.#.....#.#...#...#
###.#.###.#######.#.#####.#
#.#.#...#.......#.#.....#.#
#.#.#.#.###.###.###.#.#.#.#
#.#.#.#...#...#...#.#.#.#.#
#.#####.#####.###.#.#.###.#
#.....#.....#...#.#.#...#.#
#.###.###.#.#.#####.#.#####
#...#...#.#.#.....#.#.....#
#.#.#######.#.#.#.#.#######
#.#.......#.#.#.#.#.......#
#######.#######.#.#.#######
#.....#.......#.#.#.......#
#############.#.#.#.#.#.###
#...........#.#.#.#.#.#...#
#.#.#.#.#.#.#.#.###.###.#.#
#..............S..#...#.#.#
#.#.#########.#.#.#.#.###.#
#.#.........#.#.#.#.#...#.#
#.#######.#.#.###.#.#.###.#
#E......#.#.#...#.#.#...#.#
#########.#.#######.#######
#.......#.#.......#.......#
#.#####.###.#.#.###.#.###.#
#.....#...#.#.#...#.#...#.#
###########################
