###########################
#.......#.#...........#...#
#.#####.#.#.#####.#####.#.#
#.....#...#.#.#...#.....#.#
#.###.#####.#.#.###.#####.#
#.#.#...#...#.#.#...#...#.#
#.#.###.#.###.#.#.###.###.#
#...#.#.#...#.#...#...#E..#
###.#.#.###.#.#####.###.#.#
#.....#...#.#.......#...#.#
#######.#.#.#####.#.#.###.#
#S....#.#...#...#.#.#.#...#
#####.###.###.#.#.###.#.###
#...#...#.#...#...#...#.#.#
#.#.###.#.#.#####.#.###.#.#
#.#...#.#...#.....#.#.....#
#####.#.#####.#####.#####.#
#.....#...#...#...#...#.#.#
#.#######.#.###.#.###.#.#.#
#.#.......#...#.#...#.#...#
#.#.###########.###.#.###.#
#...#.......#...#.#.#...#.#
#.#####.#.#.#.###.#.###.###
#.....#.#.#.#...#.#...#...#
#####.#.#.#.#.#.#.###.###.#
#...#.#.#.#.#.#.#.....#...#
#.###.#.#.#.#.#.#.#####.#.#
#.....#.#.#.#.#.#.....#.#.#
#.#######.#.###.#####.#.#.#
#.........#.....#.......#.#
###########################
