###########################
#.........................#
#.#######.###.#.#########.#
#.......#...#.#.........#.#
###.#######.#.#########.###
#.#.......#.#.........#...#
#####.#.#.#.###.#.#.#####.#
#...#.#.#.#...#.#.#.....#.#
###.#.#.#########.#####.###
#.#.#.#.........#.....#...#
#.###.#.#.#.#######.#.#####
#...#.#.#.#.......#.#.....#
#.#######.#####.#######.#.#
#.......#.....#.......#.#.#
#.###.#.#.###.###.#####.###
#....................E#...#
#.###.#######.#########.###
#S..#.......#.........#...#
#.#.#####.###.#.###.###.#.#
#.#.....#...#.#...#...#.#.#
###.#.###.###.#.#####.#####
#.#.#...#...#.#.....#.....#
###.#.#.#.#.###.#.#####.#.#
#.#.#.#.#.#...#.#.....#.#.#
#######.#.###.#.###.#######
#.....#.#...#.#...#.......#
###.#.#######.###.###.#.###
#.#.#.......#...#...#.#...#
#####.#.#.###.#########.###
#...#.#.#...#.........#...#
###########################
