###########################
#...#.#...#.....#.#...#...#
#.#.#.###.#.#####.#.#.#.###
#.#......E#...#.....#...#.#
###.###.#####.###.#####.#.#
#.#...#.#.#.....#.....#...#
#.#.#####.#.#.#.#.#.#.###.#
#...........#.#...#.#...#.#
###.#####.#.#.###########.#
#...#.#.#.#.#.#.......#...#
#.###.#.#########.#.###.###
#...#.....#.......#.#.....#
#####.#####.#.#.#####.###.#
#...........#.#.........#.#
#.###.#####.#.###.#.#.#####
#.#.......#.#...#.#.#.....#
#######.###.#######.#.#.###
#.#...#.#.#.#...#S#.#.#...#
#.###.#.#.###.#.#.#.#######
#.......#...#.#...#.......#
#.###.#####.#####.###.#####
#...#.....#...#.....#.....#
#.#.#####.###.#.###.#.###.#
#.#...#.......#...#.#.#.#.#
#############.###.#.#.#.###
#.....#.........#.#...#.#.#
#.#.#.#.###############.#.#
#.#.#.#.#.....#.......#.#.#
###.#.#.#.#.#####.#.#.#.#.#
#...#.....#.......#.#.....#
###########################
