###########################
#.#S....#...........#.....#
#.#####.###.#.#######.#.###
#...........#.#...#.#.#.#.#
#########.#######.#.#.###.#
#...#...#...#.#.......#.#.#
#.#####.###.#.###.#.###.#.#
#.........#.....#.#.......#
#.#########.###.#.#.#######
#...#.........#...#...#...#
#.###########.#.#####.###.#
#...#.....#...#...#.#.....#
#.###.###.#.#####.#.#####.#
#...#.#...#.....#.#.#...#.#
#.#####.###.###.###.#.###.#
#.....#...#.#.....#...#.#.#
#.#####.#######.#.#.#.#.###
#...#...........#.#.#.#.#.#
#.#####.###.#.#.###.###.#.#
#E#.#.#.#...#.#...#.....#.#
#.#.#.#.#####.#####.###.#.#
#.......#...........#.....#
#.#######.#.###.#######.###
#.#.#...#.#...#.#.....#...#
#.#.###.###.###.#####.#####
#...#...#.#.#.....#...#.#.#
###.###.#.#.#.#######.#.#.#
#.....#.....#.....#.......#
#.#.###.#.#####.#####.#.#.#
#.#.#...#...#.........#.#.#
###########################
