###########################
#.........................#
#.#######.#.#.#.#.#.#.#####
#.......#.#.#.#.#.#.#.....#
#########.#.###############
#.......#.#...............#
#.#########.#####.#.#####.#
#.........#.....#.#.....#.#
#########.#.#.###.#.#.#####
#.......#.#.#...#.#.#.....#
#.#.###.###.#.#.#######.#.#
#.#...#...#.#.#.......#.#.#
#.###.###.#.#######.#####.#
#...#...#.#.......#.....#.#
#.#########.#.#.#####.#.#.#
#.........#.#.#.....#.#.#.#
#######.###.###.#.#.###.#.#
#.....#...#...#.#.#...#.#.#
###.#.#######.#####.###.#.#
#.#.#.......#.....#...#.#.#
###.#######.#.###.###.#.#.#
#.#.......#.#...#...#.#.#.#
###.#########.#.#.#.#.#####
#.#.........#.#.#.#.#.....#
###.###.#.###.#####.#####.#
#.#...#E..................#
###.#.###.#.#.###########.#
#.#.#...#.#.#...........#S#
#.#####.###.#.###.#####.#.#
#.....#...#.#...#.....#.#.#
###########################
