###########################
#.....#.....#.#...#.#.#...#
#####.#.#####.###.#.#.#.#.#
#.....#...#.........#...#.#
###.###.#.#.###########.#.#
#...#.#.#E#...#.#.#.....#.#
###.#.#.#####.#.#.###.###.#
#.#...#.....#.........#...#
#.###.#####.#######.#####.#
#.#...#.....#.......#.#...#
#.#.#####.#####.###.#.#####
#.....#.....#.....#.#.#...#
#.###.#.#####.#.###.#.#.###
#...#.#.#.#...#.#........S#
#.###.#.#.#.#####.#.#.#####
#...#.#.#.#...#...#.#...#.#
#.#.###.#.#.#.#########.#.#
#.#.........#...#.....#...#
###.#######.###.#.#####.###
#.........#.#.....#.#.....#
###.###.#########.#.#####.#
#.#.#.......#...#...#...#.#
#.#.#.#.#######.#.#####.#.#
#...#.#.#...#.#.......#.#.#
#.#####.#.#.#.#####.###.###
#.#.#...#.#.#...#.........#
###.#######.#.###.###.#.#.#
#.#.#.......#.......#.#.#.#
#.#.###.#.#.#.###.#.#####.#
#.......#.#.....#.#...#...#
###########################
