#############################
#.#.....#...................#
#.#####.###.###.###.###.###.#
#.....#.#...#...#...#.#.#...#
###.###.#.###.#####.#.#######
#.......#...#.#.....#.......#
#.#######.###.###.#.###.#####
#...#.....#...#...#.....#.#.#
#.#####.###.#####.#.#.###.#.#
#.#S......#...#.#.#.#...#.#.#
#.#####.###.###.#####.#.#.#.#
#.....#.#.....#...#...#.....#
###.###.#####.#.#########.#.#
#.........#...........#E..#.#
#############################
