#############################
#.....#.#S#...#.#.........#.#
###.#.#.#.#.###.#####.###.#.#
#...#.....#...........#.#.#.#
###.#########.#######.#.#.#.#
#...#.....#.....#.#...#...#.#
###.#####.###.#.#.#.#####.#.#
#.#.#...#.....#.#.#...#...#.#
#.#.#.###.#.#.#.#.#.#.#####.#
#...#...#.#.#.#...#.#E......#
#.#.#.###.#.#####.###.###.###
#.#.......#...#.....#.#.....#
#############################
