#############################
#..........E................#
###.#.#.###.#.#.###.#####.#.#
#.#...#...#.#.#...#.....#.#.#
#####.###.#############.#.#.#
#...#...#.............#.#.#.#
#.#.#.###.#####.#.#.###.###.#
#.#.....#.....#.#.#...#...#.#
###.#.#####.#####.#.#########
#.#.......#.....#.#.........#
#####.###.#.#.#############.#
#...#S..#.#.#.............#.#
#############################
