#############################
#.........#.......#.......#.#
#.#########.#####.#.#.###.#.#
#.......#...#...#...#.#...#.#
#.#####.#.###.#.#####.#.###.#
#.#.....#.#...#...#...#.#...#
###.###.#.###.#.###.###.#.#.#
#...#.#.#.#...#.#...#.#.#.#.#
#.###.#.#.#.###.#.###.#.###.#
#.#.....#.#...#.#...#.#...#.#
#.#######.###.#####.#.###.#.#
#...#...#.....#.....#...#.#.#
#.#.#.#.###.###.#.#####.#.#.#
#.#...#.#...#...#.#S#...#.#.#
#.#####.#.###.#.###.#.###.#.#
#.#.....#.#.#.#.#...#...#.#.#
#.#.#####.#.#.###.###.#.#.#.#
#.#..E......#.....#...#.....#
#############################
