#############################
#...........................#
###.#.#.#.#.#.#####.###.###.#
#.#.#.#S#.#.#.....#...#E..#.#
###.#.#####.#.#.#####.#.#.#.#
#.#.#.....#.#.#.....#.#.#.#.#
###.###.#.###.###.#.###.#####
#.#...#.#...#...#.#...#.....#
###.#.#.#####.###.#.###.###.#
#.#.#.#.....#...#.#...#...#.#
#.#.#####.#####.#####.###.#.#
#.#.....#.....#.....#...#.#.#
#.#.#.#.#####.###.#.#.#.#.###
#.#.#.#.....#...#.#.#.#.#...#
#.#.#.#.#.#.#######.#.#####.#
#.#.#.#.#.#.......#.#.....#.#
#############################
