#############################
#...........................#
#####.#.#.#.#####.###.#####.#
#...#.#.#.#.....#S..#.....#.#
#.###.#.#.###.#.#######.#####
#...#.#.#...#.#.......#.....#
###.#####.#.#.#.###.#.#####.#
#.#.....#.#.#.#...#.#.....#.#
#.#.#.###.#.#.#.#.#.###.#.#.#
#.#.#...#.#.#.#.#.#...#.#.#.#
#.#.#.#.#.###.#.#######.#####
#.#.#.#.#...#.#.......#.....#
###.#.#################.#####
#.#.#.................#E....#
###.###.#.#.###.#####.#####.#
#.#...#.#.#...#.....#.....#.#
#.#.#.###.#.#.#.#######.###.#
#.#.#...#.#.#.#.......#...#.#
#############################
