#############################
#.......#..S#.#.......#...#.#
#.###.###.###.#####.#####.#.#
#.#.............#.....#...#.#
#.#.#########.#####.#####.#.#
#.#.....#...#...#...#....E#.#
#.#####.#.#####.#.#.#####.#.#
#.....#.......#...#...#...#.#
###.#####.#.#######.#####.#.#
#.#...#.#.#...#...........#.#
#.#.#.#.#.###############.#.#
#.#.#.#.......#.........#...#
#.#.###.#.#.###.#######.###.#
#...#...#.#...#.#...........#
#############################
