#############################
#...........#...............#
###.#######.#.#############.#
#...#.....#.#.#.......#.....#
#.#.#.###.###.#####.#.#.#####
#.#.#...#...#.....#.#.#.....#
#.#####.###.#####.#.#.#####.#
#.....#.#.#...#S..#.#.....#.#
#####.#.#.###.#####.###.###.#
#...#.#.#...#...#...#.#..E#.#
#.#.#.#.#.#.###.#.###.###.#.#
#.#...#.#.#...#...#.....#...#
#.#####.#####.#########.#####
#...........................#
#############################
