#############################
#...........................#
###.#######.###.#######.###.#
#.#.......#...#.......#...#.#
###########.#.#.#.#.###.###.#
#.........#E#.#.#.#...#...#.#
#.#.#.#####.#.#.###.###.###.#
#.#.#.....#.#.#...#..S#...#.#
###.###.#####.#.#.###.###.###
#.#...#.....#.#.#...#...#...#
#############################
