#############################
#.#.....#....E..#.....#.....#
#.#.#.###.#.###.#.###.#.###.#
#...#.....#.#...#...#.#.#.#.#
#.#########.#.#####.#.#.#.#.#
#.#.......#.#.......#.#...#.#
#.###.###.#.#.#######.###.#.#
#...#...#.#.#.#...#.....#.#S#
###.#####.#.###.#.#######.###
#.........#.....#...........#
#############################
