#############################
#...........................#
###.#.#.###.###.#######.###.#
#.#.#.#..S#...#.......#...#.#
###.#.###.#.#.#.###.###.#.###
#.#.#...#.#.#.#...#...#.#...#
#######.#####.#.#.###.#.#.###
#.....#.....#.#.#...#.#.#E..#
#.#.#######.#######.#.#.###.#
#.#.......#.......#.#.#...#.#
#############################
