#############################
#...............#.....#.....#
#####.#####.###.#.###.###.#.#
#.....#.#...#.#.#.#.....#.#.#
#######.#.###.#.#.#########.#
#.........#.......#.#...#...#
#.#####.###.###.###.#.#.###.#
#...#...#...#.#.#.#...#.#.#.#
#.###.#####.#.###.#####.#.#.#
#.#.#.#.....#E............#.#
###.#.#####.#.###.#.#######.#
#S#...#.#.....#...#.#.....#.#
#.###.#.#.#####.###.#####.#.#
#.....#.#.#...#.#.#.#...#...#
#.#####.###.#.#.#.#.###.###.#
#...#.......#...#.#...#.....#
#.###.#.#########.###.#.#####
#.#...#.........#...........#
#############################
