#############################
#.........#.........#.......#
#.#####.###.#.#####.###.###.#
#.#...#.....#.....#.#...#...#
#.#.#.#########.#.#.#.#####.#
#.#S#.........#.#.#.#.....#.#
#.###########.###.#.#.###.#.#
#.#.........#.#...#.#...#.#.#
#.#.#######.#.#.###.#####.#.#
#...#.......#...#......E..#.#
#############################
