#############################
#...........#.........#.#...#
###.###.#.#####.#.###.#.#.#.#
#.#.#...#.....#.#.#.....#.#.#
#.#.#######.#.#.#####.#####.#
#.........#.#.#...#.....#.#.#
#.###.#######.#####.#####.#.#
#...#.#.#...#.#...#E....#...#
###.###.#.#####.###.#####.###
#.#.#.#.......#...#.........#
#.#.#.#.#.#.###.#######.#.#.#
#.......#.#.............#.#.#
###.###.#########.###.#.#####
#.....#.#.#.#.....#.#.#...#S#
###.#.#.#.#.###.###.#######.#
#...#.#.......#.............#
#############################
