#############################
#................E..........#
#.#.#####.###.#######.#.#.#.#
#.#.....#...#.......#.#.#.#.#
#####.#.#.#.###.#.#.#####.###
#...#.#.#.#...#.#.#.....#...#
#.###.#####.###.#.#.#########
#...#.....#S..#.#.#.........#
#.#.#.###.#########.#.###.###
#.#.#...#.........#.#...#...#
#############################
