#############################
#...........................#
#.###.#########.#.#.#######.#
#...#.........#E#.#.......#.#
###.#####.#.#######.#.#.#####
#.#.....#.#.......#.#.#.....#
#.###.#.###.#.#####.###.#####
#...#.#...#.#.....#...#.....#
#####.###.#.#.#####.#.#####.#
#...#...#.#.#.....#.#.....#.#
###.#.###.#.###.#.#.#####.#.#
#.#.#...#.#...#.#.#..S..#.#.#
###.#.#.#.#.#.#.#######.#.###
#.#.#.#.#.#.#.#.......#.#...#
#############################
