#############################
#....S......................#
#.#.#####.#.###.#.#.###.#.###
#.#.....#.#...#.#.#...#.#...#
###.###.###########.#.#######
#.....#...........#.#.......#
#.#.###.#.#.#.###.#.#########
#.#...#.#.#.#...#.#.........#
#.#.###.###.#.#.#.#.###.###.#
#.....#...#.#.#.#.#...#...#.#
###.###########.#.#.#.#.#.###
#.#...........#.#.#.#.#.#...#
#.#.#.#########.###.#.#.#.###
#.#E#.........#...#.#.#.#...#
#############################
