#############################
#...........................#
#.#.#######.#.#####.#.#######
#.#.......#.#.....#.#.......#
#######.#######.#####.#.#.###
#.....#.......#.....#.#.#..E#
#.#########.#.#.#.#.#########
#.........#.#.#.#.#.........#
#.#.#.#######.#.###.#.###.#.#
#.#.#.......#.#..S#.#...#.#.#
#.###########.###.#.###.###.#
#...........#...#.#...#...#.#
#############################
