#############################
#...........................#
#.#####.#.#.#.###.#.#####.#.#
#.....#.#.#.#...#.#.....#.#.#
###########.#####.#####.###.#
#.........#.....#.....#...#.#
#########.#.#.#.#######.#.###
#..S..................#.#...#
#####.#.###.#####.#.#.#.#####
#...#.#...#.....#.#.#.#.....#
#####.#####.###.#.###.#.###.#
#...#.....#...#..E..#.#...#.#
#.#.###########.#.#.###.#.#.#
#.#...........#.#.#...#.#.#.#
#.#.#####.#####.#####.#####.#
#.#.....#.....#.....#.....#.#
#############################
