#############################
#.....#...#.......#.........#
#.#######.#.#####.###.#.###.#
#.....#...#.....#.....#E..#.#
#.###.###.#.#########.#.###.#
#...#.......#.#...#...#.#...#
###.#######.#.#.###.###.#.#.#
#S#.#.............#.#...#.#.#
#.###.#####.###.###########.#
#.........#.#.........#...#.#
#######.#.###.#.#.###.###.###
#.....#.#...#.#.#.#.#.#.#...#
###.#######.#.#####.###.#.###
#...........#...............#
#############################
