#############################
#.........#.#...#...........#
#.###.#####.#.#.#.#########.#
#...#...#S#...#.........#...#
###.#.###.#######.###########
#.#.#...#.#.......#.#...#...#
#.#####.#.#.###.###.###.#.#.#
#.#.......#.#.........#...#.#
#.#.#####.#######.#####.###.#
#.......#...#...#.#.#...#...#
#.###.#.#.#.###.#.#.#.###.###
#.#.#.#.#.#...#...#.#.#.#...#
#.#.#.#####.###.#.#.#.#.#####
#.#E#.#...#...#.#.....#.....#
#.#.###.#.###.#.###.#.#.#.###
#.......#...#.....#.#...#...#
#############################
