#############################
#...#.#...#.......#.....#...#
###.#.#.#######.#.#.#####.#.#
#.............#.#.....#...#.#
#.#######.#.#.#####.#####.#.#
#.......#.#.#.#.........#.#.#
###.#####.###.#.#######.#.###
#.#.....#...#.....#...#.....#
#.#.#####.###.###.###.#####.#
#...#S....#.....#..E......#.#
#############################
