#############################
#.....#.#.............#.#...#
#.###.#.#.#####.#####.#.#.#.#
#.#.....#.#...#.#...#.#...#.#
#.#####.#.#.#.#.#.#.#.#.###.#
#.#...#.#.#.#.#.#.#...#.#...#
#.#.#.###.#.###.#####.###.#.#
#...#.......#...#...#...#.#.#
#.###########.#.#.#.###.#.#.#
#.#...........#.#.#.#.....#.#
#.#.###########.#.#.#########
#.#...........#.#.#.........#
#.###########.###.#####.###.#
#.#.........#.#...#..S#...#.#
#.#.#######.#.#.###.#######.#
#..E#.......#.....#.........#
#############################
