#############################
#...........................#
#.#.#####.###.#.#####.#.#####
#.#.....#...#.#.....#.#.....#
#.###.#####.#.###.#.#.###.###
#...#.....#.#...#E#.#...#...#
#####.#.#.#.#.#.#########.###
#...#.#.#.#.#.#.........#...#
#.#.#.###.#.###.###.###.#####
#.#.#...#.#...#...#...#.....#
#.#.#.###########.###.#.#####
#.#.#...........#...#.#.....#
###.###.#########.#####.#####
#.#...#.........#.....#.....#
#.###.#####.#.#####.#.#.#.###
#...#.....#.#S....#.#.#.#...#
#.###.###.#######.#.#########
#...#...#.......#.#.........#
#############################
