#############################
#...........................#
###.#.#.#.#.#####.#.###.#####
#.#E#.#.#.#.....#.#...#.....#
###.###.#.#.#####.#.#.###.###
#.#...#.#.#.....#.#.#...#...#
#####.#.#########.###.#####.#
#...#.#.........#...#.....#.#
#.###.#########.#.###.#.#.###
#...#.........#.#..S#.#.#...#
#.#####.#.#########.#.#######
#.....#.#.........#.#.......#
#######.#.#.###.#.#.#.#.#.#.#
#.....#.#.#...#.#.#.#.#.#.#.#
#.#.#.#####.#.#######.#######
#.#.#.....#.#.......#.......#
#############################
