#############################
#.....#...............#.....#
#.###.#.#########.#.###.###.#
#...#...#.....#...#.#...#.#.#
#.#######.###.#.#.###.###.#.#
#.#.......#.....#.#...#...#.#
#.#.#.#############.###.#.#.#
#.#.#.#E..........#.....#.#.#
###.#.#.#########.#######.#.#
#...#.#.#.......#.........#.#
#.#####.#####.#.#########.#.#
#.#.....#...#.#.#...#...#.#.#
#.#.#####.#.#.#.###.#.#.###.#
#.#.....#.#.#.#.....#.#.....#
#.#####.#.#.#.#.#####.#####.#
#.........#...#.#S....#.....#
#############################
