#############################
#...................#.......#
#####.#####.#######.#.###.#.#
#.....#..E#.#.....#.#.#...#.#
#.#####.#.###.###.#.###.#####
#.#.....#.....#...#...#.....#
#.#.###########.#####.#####.#
#.#.#.....#...#.#.#...#...#.#
#.#.#.###.###.#.#.#.###.#.#.#
#...#.#.#...#.#.#.......#.#.#
#.###.#.###.#.#.#########.#.#
#.#...#.....#.#...#.........#
#.#.#####.###.###.###########
#.#.....#.#...#...#........S#
#.#.###.#.#.#.#.###.#########
#.#...#.#...#.#...#.....#...#
#.#####.#####.###.#####.###.#
#.......#.......#...........#
#############################
