#############################
#...#...............#.......#
###.#.#####.###.###.#.#######
#...#.#...#...#.#...#.......#
#.###.#.#.#####.#.###.#####.#
#.....#.#.......#.#.......#.#
#.#####.#########.#.#######.#
#.#..S#...#.....#.#.#.....#.#
#.#.#####.#.#####.###.###.#.#
#.#...#...#.....#.....#.#...#
#.###.#.###.###.#######.###.#
#...#...#.....#..........E..#
#############################
