#############################
#.#.......#.......#.......#.#
#.#.#.#####.###.###.#.###.#.#
#...#...#..E#...#...#...#.#.#
#######.#.###.#.#.#####.#.#.#
#.....#.#.#.#.#.#...#.#.#.#.#
#.###.#.#.#.#.#####.#.#.#.#.#
#.#.....#.#.#.....#.#.#.#...#
#.###.###.#.#####.#.#.#.###.#
#...#.#...#...#...#.#.#...#.#
#.#.###.###.#.#.###.#.###.#.#
#.#.........#.#.......#S..#.#
#############################
