#############################
#...........................#
#####.#.#.#.###.#.#.###.#####
#...#.#.#.#...#.#.#...#.....#
#.#.#.#.###.#.###.#.#.#######
#.#.#.#...#.#...#.#.#.......#
###.#.###.#.#.###.#.#####.###
#.#.#...#.#.#...#.#.....#...#
#########.#.#.#####.#.#.#####
#.......#S#.#.....#.#.#.....#
#.#.#.#.###.#.#####.#.#######
#.#.#.#...#.#.....#.#E......#
###########.###.#.#.#######.#
#.........#...#.#.#.......#.#
#############################
