#############################
#...#...#S......#.#.....#...#
###.#.#.###.#.#.#.#####.###.#
#.....#.#.#.#.#.......#.....#
###.###.#.#.###.###.#.###.#.#
#.....#...#.#.....#.#.....#.#
#.###.#####.###.#######.#####
#...#.....#...#.#.......#...#
#.#####.###.###.###.#####.###
#.....#.......#...#.......#.#
###.#######.#######.#.###.#.#
#.........#.#..E....#...#...#
#############################
