#############################
#.....#...#...#...........#S#
#####.#.###.#.#.#.#####.###.#
#...#.#.....#...#...#...#.#.#
###.#.#######.#########.#.#.#
#.....#.....#.......#...#.#.#
#.#######.#.#.#.###.#####.#.#
#.....#.#.#...#.#.........#.#
#####.#.#.#####.###.###.###.#
#..E#.#.......#.#.#.#...#.#.#
#.###.#.###.#####.#####.#.#.#
#.........#.#...#...#...#...#
#.#####.#.#.#.###.#.#.#.#.###
#.#.....#.#.#.#.#.#.#.#.....#
#.#.###.###.#.#.#.#.#######.#
#.#.#.#.#.......#.#...#.....#
#.###.#.#.#####.#.#######.#.#
#...#...#...#.........#...#.#
#############################
