#############################
#..............S............#
#.#.#######.#.#.###.#.#.###.#
#.#.......#.#.#...#.#.#...#.#
#####.#.###.###.#######.#.#.#
#...#.#...#...#.......#.#.#.#
###.#####.#########.#.#.###.#
#.#.....#.........#.#.#...#.#
###.#.###.#######.#.###.#.#.#
#.#.#...#.......#.#...#.#.#.#
#.#########.#####.###.#.###.#
#.........#.....#...#.#..E#.#
#############################
