#############################
#S......#.#.#.......#...#...#
#######.#.#.###.#.#.###.#.#.#
#.#.#...#.......#.#...#..E#.#
#.#.###.#####.###.###.###.###
#.............#...#.#.....#.#
###.#######.###.#.#.#######.#
#.#.#.......#.#.#.#.........#
#.#.#######.#.###.#.#.#.###.#
#.....#.....#.......#.#...#.#
#############################
