#############################
#...........#...........#...#
#.#########.#.#######.###.#.#
#.#.....#.#...#.....#.....#.#
#.#.###.#.#####.###.#######.#
#...#.#.#...#.....#.......#.#
#####.#.###.#.###.#####.###.#
#.#.....#...#.#.#.....#.#S..#
#.#.#####.###.#.#####.#.#####
#.#...#.#.....#.....#.#.#...#
#.###.#.#.#######.#.#.###.#.#
#.#...#...#.......#.#.....#.#
#.#.###.###.###############.#
#.#.#..E....#.......#.....#.#
#.#.#####.###.#####.#.###.#.#
#.#...#...#...#...#...#.#...#
#.###.#####.###.#.#####.###.#
#...........#...#...........#
#############################
