#############################
#.........#.#...........#...#
#.#.#####.#.#.#####.###.#.#.#
#.#...#.....#.....#...#.#.#.#
#.###.#########.#####.#.#.#.#
#...#...........#.....#...#.#
###.#############.###.#######
#.#.......#.....#.#...#...#S#
#.#######.###.#.#.#####.#.#.#
#.#.....#.#...#.#.......#...#
#.#.###.#.#.###.#############
#....E#.....#...............#
#############################
