#############################
#.............#...#.......#.#
#.#.#.#.#########.#####.#.#.#
#.#.#.#...#.....#.....#.#E#.#
#####.#####.#.#####.###.###.#
#.....#.....#.......#.......#
###.#######.#.#####.###.#####
#.#.....#...#.#.....#.#.....#
#.#####.###.###.#####.#.#.#.#
#.#.........#.......#...#.#.#
#.#.#####.#.###.#####.###.###
#.#.#.#.#.#.#.....#...#.....#
#.#.#.#.#.#####.#########.#.#
#.#.#.#...#.#...#.........#.#
#.#.#.#.###.###.#.###.#.#.###
#.#.#.......#.#.....#.#.#...#
#.#.###.###.#.#####.#.###.#.#
#...#....S#...#.....#...#.#.#
#############################
