#############################
#.........#.....#.....#S..#.#
#.#####.#.###.###.#.#####.#.#
#.#.#...#.....#...#.......#.#
#.#.#.#######.#.###########.#
#...#.#.......#.#...........#
###.#.#########.#######.###.#
#.#.#...#.......#.......#.#.#
#.#.###.#.#######.#######.#.#
#...#.#...#.....#...#.#.....#
#.###.#####.###.###.#.#.#####
#.#.....#...#.#.....#.#.#...#
#.#.###.#.###.#######.#.#.#.#
#...#.....#......E........#.#
#############################
