#############################
#................E..........#
#.#####.###.#.#.#.#######.#.#
#.....#...#.#.#.#.......#.#.#
#.#.###.#.#.#.###.###.#.#####
#.#...#.#.#.#...#...#.#.....#
#.#.#.#.###.#.#####.###.#.#.#
#.#.#.#...#.#.....#...#.#.#.#
#######.#.###.###.#.###.#.###
#.....#.#...#...#.#...#.#...#
#####.#.#####.#.#####.#######
#...#.#.....#.#.....#.......#
###.#######.#.#.#############
#.#.......#.#.#.............#
#.#####.#.#########.#.#.#.#.#
#.....#.#.........#.#.#.#.#S#
#.###.###.###.#.#.#.###.#.#.#
#...#...#...#.#.#.#...#.#.#.#
#############################
