#############################
#.#.....#...#.........#.#...#
#.###.#.###.#.###.#####.###.#
#.#...#...#.#.#.....#...#.#.#
#.#.#.#####.#######.###.#.#.#
#.#.#.#....E#.........#.#.#.#
#.#.#.#.#.#.#.#######.#.#.#.#
#...#...#.#.#.#.#...#...#...#
#.###.#.#.###.#.#.###.###.#.#
#...#.#.#...#.#.#...#.....#.#
#######.#######.#.#####.###.#
#S......................#...#
#############################
