#############################
#.#.....#.......#.#.........#
#.#.#.#######.###.#.#.#######
#...#.......#.....#.#.....#.#
#.#.#####.#.#.#####.#.###.#.#
#.#.#.....#.#.#.....#.#.....#
###.###.#.###.#.#.###########
#.#.#...#...#...#...#.......#
#.#.#######.#.#.###.###.###.#
#.......#...#.#.#.......#...#
#.#####.###########.###.#.#.#
#.#...#.....#.#...#...#.#.#.#
#.#.#########.###.###.#####.#
#E#...........#.#.....#.#.#.#
#.###########.#.###.###.#.###
#.........#...........#...#.#
#.###.#.#.#.#.#.#.#.#.#.###.#
#.#.#.#.#...#.#.#.#.#.#.....#
###.###.#######.#.#####.###.#
#.#.......#.#...#.#...#.#.#.#
#.#.#######.#.###.#.#.#.#.###
#...#.......#...#...#...#...#
###.#####.###.#.#.###.#.#.#.#
#.......#.....#.#...#.#...#S#
#############################
