#############################
#...........................#
#######.#.#.#.###.###.#######
#.....#.#.#.#...#...#.......#
###.###.#.#.#######.#########
#.#...#.#.#....E..#.........#
#.#######.#.#.#.###.#.#######
#.......#.#.#.#...#.#.......#
###.#.#######.###.#.###.#####
#.#.#.......#...#.#...#.....#
###.###.###.#.#.#########.#.#
#.#...#...#.#.#.........#.#.#
#######.#.#.#.#.#.#.###.#.###
#.....#.#.#.#.#.#.#...#.#..S#
#####.#.#.#.#.#.#####.###.###
#...#.#.#.#.#.#.....#...#...#
#####.#.#.###.#######.#####.#
#...#.#.#...#.......#.....#.#
###.#.#.###.#.#.#.#.#.#.#.###
#.#.#.#...#.#.#.#.#.#.#.#...#
#############################
