#############################
#...#.......................#
###.#########.#######.###.#.#
#.......#.........#.....#.#.#
#.###.#####.#.#######.###.###
#.#.#...#...#.....#.....#...#
#.#.#.#.###.#####.###.#.###.#
#.#...#.#.#.#.#..E..#.#...#.#
#.###.###.###.#.#######.#.###
#...#...#.....#.#.......#...#
#######.###.#.###.#####.###.#
#.....#...#.#.#.#.#.....#...#
###.#####.#.#.#.#.###.#####.#
#.#.......#.#...#.#.....#...#
#.###.#.#.#####.#.###.#####.#
#.#...#.#.....#.#.#.#...#...#
#.#.#######.###.###.#####.###
#.........#.....#.#.......#.#
#.###.#####.#.###.#.#.#####.#
#...#.#...#.#...#...#.#...#.#
#.###.#.#######.###.#####.#.#
#.#.....#...#.#.#...#.....#.#
#.#.#######.#.#.###.#.#####.#
#.#..S#.....................#
#############################
