#############################
#.....#.....................#
#.#.#####.#####.#.#########.#
#.#...#.#.#.....#...#.#...#.#
#.###.#.###.#.#######.#.###.#
#...#.....#.#...#.......#...#
#.#.#.#.###.#.#.#####.#.#####
#.#.#.#.....#.#.#.#.#.#.....#
#.#####.#.#.#.###.#.###.#.###
#...#.#.#.#.#...#.......#...#
#.#.#.#.###.###.#.#####.#####
#.#.#.#...#.#...#.#...#.#...#
###.#.#.###.#########.#.#.#.#
#S#.#.....#.#.......#.....#.#
#.###.###.#######.#.###.#.###
#.....#.....#...#.#.#...#...#
#######.#.#.#.###.#######.#.#
#.......#.#.#...#.#E....#.#.#
#######.#######.#.#.#####.###
#.......#.........#.........#
#####.#.#.#######.###.#####.#
#.....#.........#.........#.#
#############################
