#############################
#.....#.....#...#...#...#...#
#.###.###.#.#.###.#.#.#.###.#
#...#.....#...#...#...#..E#.#
###.#.#########.#########.#.#
#...#.#...#...#...#.....#.#.#
#.###.#.#.#.#.###.#####.#.#.#
#.#...#.#...#.#...#.....#.#.#
#.#####.#####.#.###.###.#.#.#
#...#S#...#.#...#...#.#.#.#.#
#.#.#.###.#.#####.###.#.#.#.#
#.#.#.....#.......#...#.#...#
###.#######.#.#####.###.###.#
#.....#...#.#...#...#...#.#.#
#.###.#.#.#####.#.###.###.#.#
#...#...#...#...#.#...#...#.#
#.#.#.#####.#.###.#.###.###.#
#.#.#.#...#...#.........#...#
#.#.###.#.###########.###.###
#.#.#...#.......#...#.#...#.#
#.#.#.#########.#.#.###.###.#
#.#...........#...#.........#
#############################
