#############################
#...........#.......#.....#.#
#.#####.###.#.#.###.#.###.#.#
#.#...#...#.#.#.#E..#.#.#...#
#.#.#.###.#.###.#.###.#.###.#
#...#...#.#.....#.....#...#.#
#########.#############.#.#.#
#...#...#...#.........#.#...#
#.#.#.#.###.#######.#.#.#####
#.#.#.#...#.......#.#.#.#...#
#.#.#.###.#.#####.#.#.#.#.#.#
#.#.#.#...#.....#.#.#.#...#.#
#.#.#.#.#########.#.#.#####.#
#.#...#.#.....#...#.#.....#.#
#.#####.#.###.#.#####.#####.#
#.#S#...#.#.#.#.....#.#...#.#
#.#.#.###.#.#.#####.#.#.#.#.#
#...#...#.#.....#...#.#.#...#
#######.#.#####.#.###.#.#####
#.....#.#...#...#...#.#...#.#
#.###.#.#.#.#.#####.#.###.#.#
#.#...#.#.#.#.#.....#...#...#
#.#####.###.#.#.#.#####.###.#
#.#.....#...#.#.#.....#.....#
#.#.#####.###.#######.#####.#
#.#...#.....#...#...#.....#.#
#.###.#####.###.#.#.#####.#.#
#...........#.....#.......#.#
#############################
