#############################
#...#....E......#.#.......#.#
#.#.#.#######.#.#.#######.#.#
#.#...#.#.....#.#...#.......#
#####.#.#####.#.#.#######.#.#
#.#...#.....#.#...........#.#
#.###.###.#.###.#.###.###.###
#.#.....#.#.....#...#.#...#.#
#.###.###.#.###.#######.###.#
#.......#.#.#.#...#.....#...#
#######.###.#.#####.#.#.#.###
#.......#.......#.#.#.#.....#
###.#####.###.###.###.#.#####
#...#.#.#.#.....#.#.#.#.....#
#.###.#.###.###.#.#.#######.#
#.#.......#.#.#.....#.#.....#
#.#.###.#.#.#.###.#.#.#.#####
#.#...#.#.....#...#.#.#.#...#
#.#.###.#####.#####.#.#.###.#
#.#...#.....#.#...#.#.......#
#.#.#########.#.#.#.#########
#.#.#S....#...#.#...#.......#
###.###.###.#######.#######.#
#.......#...#.#.....#.....#.#
#####.#.#.#.#.#.###.###.#.#.#
#...#.#.#.#.#.#.#...#.#.#...#
#.#.###.###.#.#######.#.#.###
#.#.......#.............#...#
#############################
