#############################
#...........................#
###.###.#.###.#.#.###.#####.#
#.#...#.#...#.#.#...#.....#.#
#.#####.#####.###.#########.#
#.....#E....#...#.........#.#
#.#######.#.#.#.#######.#.###
#.......#.#.#.#.......#.#...#
###.###.###.#####.#.#####.#.#
#.#...#.........#.#.....#.#.#
###.###.#.#.###.#.###.#.###.#
#.#...#.#.#...#.#...#.#...#.#
#.###.#####.#.#.#####.#.###.#
#...#.....#.#.#.....#.#...#.#
#.###.#.#.#.###.###.#.#.#####
#...#.#.#..S..#...#.#.#.....#
#########.#.###.#.#.#######.#
#.......#.#...#.#.#.......#.#
#.###.###########.#####.#####
#...#...........#.....#.....#
#############################
