#############################
#.#.#...#.#...#.....#.....#.#
#.#.#.###.#.###.#####.#.###.#
#.#.......#.......#...#.....#
#.#######.###.###.#.#######.#
#.....#.....#.#...#.#.......#
#.#######.#.###.###.#####.###
#.....#.#.#.....#.#.#.....#.#
#.###.#.#.#.#####.#.#####.#.#
#...#.....#...#.....#...#...#
#######.#######.###.#.#.###.#
#...#.#.......#.#.#.#.#...#.#
#.###.###.###.#.#.#.###.#.###
#...#.......#.#.#.......#E#.#
#.#.#####.#.#####.###.#####.#
#.#.......#.......#...#...#.#
###.#########.#####.#####.#.#
#...#...#.#.#.....#.....#...#
#.#.###.#.#.###.#.#####.###.#
#S#...#.........#...#.......#
#############################
