#############################
#.#.#.....#.........#......E#
#.#.#.###.#.#.#######.#.#####
#...#.#.....#.#.......#...#.#
#.#.#.#####.#.#.#######.###.#
#.#.....#.#.#...#.....#.....#
#.#####.#.###.###.#########.#
#.....#.....#.#.#.#.#...#...#
###.###.###.#.#.#.#.###.###.#
#...#.#.#...#...#.....#.#...#
###.#.#######.###.#.#.#.###.#
#.#.#.......#.#...#.#.....#.#
#.#.#######.#######.#.###.#.#
#.....#.#...#.......#...#.#.#
#.###.#.#.#####.###.#####.#.#
#...#.#.....#.....#.....#...#
#.###.###.###.###.#.###.#####
#...#...#.....#...#.#.......#
#####################.#.#####
#S..#...........#.....#.#.#.#
###.#####.#.#######.###.#.#.#
#.........#...........#...#.#
#.###########.#########.###.#
#.#.........#...#.#.#.#.....#
#.#########.###.#.#.#.###.#.#
#...........#...#.........#.#
#############################
