#############################
#..........................E#
#.#.#####.###.#######.#.#.#.#
#.#.....#...#.......#.#.#.#.#
#.#.#.###.#######.###########
#.#.#...#.......#...........#
#.#.#.#######.#.###.#.###.###
#.#.#.......#.#...#.#...#...#
#.###.#######.###########.###
#...#.......#...........#...#
###.###.#.#.###.#########.#.#
#.#...#.#.#...#.........#.#.#
#.#.#####.###.#.###.#####.#.#
#.#.....#...#.#...#.....#.#.#
#######.#.#.#.#.###.###.#.###
#.....#.#.#.#.#...#...#.#...#
#.###.#####.###.#######.###.#
#...#.....#...#.......#...#.#
#.#.#.#.#.#######.#.#####.#.#
#.#.#.#.#.......#.#.....#.#.#
###.#.#.#.###.#.#####.#.#.#.#
#.#.#.#.#...#.#.....#S#.#.#.#
###.#.#.###.#.###.#.#########
#.#.#.#...#.#...#.#.........#
#.#####.#.#.###.###.#.#.#####
#.....#.#.#...#...#.#.#.....#
#############################
