#############################
#...........................#
#.#.#.#.#.#.#.#.#.###.#.###.#
#.#.#.#.#.#.#.#.#...#.#...#.#
#.#######.#.#.#.###.#######.#
#..........................E#
#.###.#.#.#.#####.###.#.#.###
#...#.#.#.#.....#...#.#.#...#
#.#.#.#.###.#.#.#.#.#.#####.#
#.#.#.#...#.#.#.#.#.#.....#.#
#.#######.#####.#.#########.#
#.......#.....#.#.........#.#
#.#.#.###.#.###.#.#.#.#.#.###
#.#.#...#.#...#.#.#.#.#.#...#
#.#.#.#.#.#.#.#####.#.#.###.#
#.#.#.#.#.#.#.....#.#.#...#.#
#.#####.#.#####.#.#.###.#.#.#
#.....#.#.....#.#.#...#.#.#.#
#.#.#####.###.#.#.#.#.#######
#S#.....#...#.#.#.#.#.......#
#############.#######.#######
#...........#.......#.......#
#.#.###.#####################
#.#...#.....................#
#############################
