#############################
#.......#.........#.....#...#
#####.#.###.#.#.#####.###.###
#.#...#.#...#.#.............#
#.#.#.#####.#.#.###.#.#####.#
#...#.#.....#.#.#...#.....#.#
#####.#.#.#####.###.###.#.#.#
#......E#.....#.#...#.#.#.#.#
#.#####.###.#########.#.#.###
#.#...#.#.#.#.#.........#...#
#.###.#.#.###.#.#######.#####
#...#.#.#...#.........#...#.#
#####.#####.#.#.#.#.#.#####.#
#.#.#.........#.#.#.#.......#
#.#.#.#.###.#####.#.#.#######
#.#...#.#.......#.#.#.....#.#
#.#######.###.###.#########.#
#...#.......#...#...........#
###.#######.#######.###.#.#.#
#...#.......#.......#...#.#.#
#.#.#####.#.#.#.#####.###.###
#.#...#...#.#.#.#...#...#...#
#####.#####.###.#.#######.###
#.....#.#...#.....#.......#.#
###.###.#.#####.#########.#.#
#S............#.........#...#
#############################
