#############################
#...........................#
#########.###.#.#.###.#.#.###
#.......#...#.#.#...#.#.#...#
#.#.#.###.###.#########.###.#
#.#.#...#...#.........#...#.#
#.#.#.#.#.#.#.#######.#######
#.#.#.#.#.#.#.......#.......#
#####.#.#########.#.#######.#
#...#.#....E....#.#.......#.#
#.###.#####.#######.#.#.#####
#...#.....#.......#.#.#.....#
#####.#.#####.###.#.#########
#...#.#.....#...#.#.........#
###.#####.#.#.#.###.#.#.#.#.#
#.#.....#.#.#.#...#.#.#.#.#.#
#########.###.#.#########.#.#
#.......#...#.#.........#.#.#
#########.#.###.#.#.#.###.#.#
#.......#.#...#.#.#.#...#.#.#
###.#.#.#.#.###.#.#.#.#######
#.#.#.#.#.#...#.#.#.#..S....#
#####.#.###.###.#.#.###.#.###
#...#.#...#...#.#.#...#.#...#
#.###.###.###.#######.#.###.#
#...#...#...#.......#.#...#.#
#########.#####.#.###########
#.......#.....#.#...........#
#############################
