#############################
#.#.#.#.......#.....#.......#
#.#.#.#.#.#####.#.#####.###.#
#....E#.#.#.#.#.#.#.......#.#
#.#.#####.#.#.###.#.#####.#.#
#.#.#.....#...#.......#.#.#.#
###.###.#####.###.###.#.#####
#.........#.......#.#.#.....#
#######.#.###.#.###.#.#.###.#
#...#.#.#...#.#.#.#.#.#.#...#
#.###.#.###.#.###.#.###.#####
#.....#.#...#.#...#...#...#.#
#####.###.#.#.###.#.###.#.#.#
#.#.#.....#.............#.#.#
#.#.###.###.#######.#.#####.#
#.....#.#.#.#.#.#...#.......#
###.#.#.#.#.#.#.#.#.#########
#.#.#...#.#.....#.#.......#.#
#.#######.###.#.#.###.#####.#
#.....#.......#.#...#.#.#...#
#####.#######.#####.###.#.#.#
#.......#.....#.........#.#.#
###.#.###.#######.#######.#.#
#...#.#.......#...........#.#
#.#.#.###.###.#########.###.#
#.#.#.....#...........#...#S#
#############################
