#############################
#.#.....#.....#.............#
#.#.###.#.###.###########.#.#
#.#...#.#.#.#.#.........#.#.#
#.#.###.#.#.#.#.#######.###.#
#.#.#...#.#.#.#S#...#...#...#
#.#.#.#.#.#.#.#####.#.###.#.#
#...#.#.#...#.......#.#...#.#
#####.#.###.#.#####.#.###.#.#
#...#.#.#...#.#...#.#.#...#.#
#.#.#.#.#.###.#.#.###.#.###.#
#.#...#.#...#...#...#.#.#...#
#.#####.###.#######.#.#.#.###
#...#.#.#...#.....#...#.#...#
###.#.#.#.#####.#.#####.#####
#...#...#.#...#.#...#...#...#
#.#.#####.#.#.#.###.###.#.#.#
#E#.#...#...#.#...#...#...#.#
#.###.#.#####.###.###.#####.#
#.....#...........#.........#
#############################
