#############################
#.........#..E..#...........#
#####.###.#.###.#.#####.###.#
#.....#...#.#.#...#...#...#.#
#.#####.###.#.#####.#####.#.#
#.#.......#.#.......#.....#.#
#.#######.#.#.#####.#.#######
#.#...#...#.#.....#.#.#.....#
#.#.#.#####.#####.#.#.#.###.#
#...#.#.....#.....#.#.#.#...#
#.###.#.#####.#.#####.#.#.###
#.#.#...#.....#.#.....#.#...#
#.#.#####.###.###.#####.###.#
#.........#...#...#.....#S..#
###########.###.#.#.#########
#.....#.....#.#.#.#.#...#...#
#.#####.#####.#.#.#.#.#.#.#.#
#.....#.......#.#.#...#...#.#
#.###.#######.#.###########.#
#.#.#.......#.#.#.....#...#.#
#.#.###.#####.#.#.###.#.#.#.#
#.....#.......#.....#...#...#
#############################
