#############################
#.....#.......#.......#.....#
#.###.#.#####.###.#.#.#.###.#
#.#.....#...#...#.#.#.#...#.#
#.#######.#.###.###.#.#####.#
#.....#.#.#...#.#...#.......#
#.###.#.#.#.#.#.#.#########.#
#.#...#...#.#.#.#.#.......#.#
###.#######.#.#.#.#.#.###.#.#
#...#.......#.#...#.#.#...#.#
#.###.#############.#.#.###.#
#...#.#...#.......#.#.#.#...#
#.#.#.#.#.#.#####.#.#.###.###
#.#.#...#.....#..E#.#...#...#
#.#.#########.#.###.###.###.#
#.#.........#.#.....#...#...#
#.#########.#########.###.###
#...#.......#.........#...#.#
#####.#######.#######.#.###.#
#.....#S..#.....#.....#.#...#
#.#.#####.#####.#######.#.#.#
#.#.#...#.....#.#.......#.#.#
#.###.#.#####.#.#.#######.#.#
#.....#.......#...........#.#
#############################
