#############################
#...#.#S......#...#.....#.#.#
###.#.#######.###.#####.#.#.#
#.........#...#.#...#.#...#.#
#####.#####.###.#.#.#.###.#.#
#...#...#...#.....#.....#...#
###.#.#####.###.###.###.###.#
#.#...#.#...#...#...#.....#.#
#.#.#.#.#.#####.#.#######.#.#
#...#.#.#...#...#.#...#...#.#
#####.#.#.#.###.###.#.#####.#
#.....#...#.#.......#E..#...#
###.#.#.#.#########.#####.#.#
#...#...#...#.....#.......#.#
#.#######.#.#.###.#######.###
#.....#.#.#.....#...........#
#.#####.#.#.#####.###.#######
#...#.#...#.#.#.#...#...#.#.#
#####.#.#####.#.###.#####.#.#
#...#.....#.#.....#.#.......#
#.#.###.#.#.#.#.#####.#######
#.#...#.#.#...#.......#.#...#
#.#####.###.###.#####.#.###.#
#.#.#.......#...#...........#
#.#.###.#.#######.###.#.#.###
#.#.....#.......#...#.#.#...#
#.#####.###.#.#.###.#.#####.#
#.........#.#.#...#.#...#...#
#############################
