#############################
#......S#.........#.#...#.#.#
#.#.#########.#.###.#.###.#.#
#.#.....#.#...#.#...........#
###.#####.#.###.#.#####.#.#.#
#.....#.......#.#.#...#.#.#.#
#.#.#.###.###########.#.###.#
#.#.#.#...#.....#.#.#...#...#
#.#.#####.#.#####.#.#.#####.#
#.#...#...#.#.#.........#.#.#
###.#.#.#.#.#.###.#.#.#.#.###
#.#.#...#.........#.#.#.....#
#.###.#####.#######.#######.#
#...#.#.#...#.#.#.....#...#.#
#.###.#.###.#.#.#######.#.#.#
#.#.#...#.#...#.......#.#.#.#
#.#.#####.###.#.#####.###.#.#
#.#.#...#...#.#.#.#.#.....#.#
#.#.#.###.###.#.#.#.#####.#.#
#E............#...#.....#.#.#
###.#.###.###.###.#.#.#.#.###
#...#.#...#.......#.#.#...#.#
###########.###.#######.###.#
#.#.....#.#.#.........#.....#
#.#.#####.#.###.#.#####.###.#
#.#.#.......#...#.#...#.#...#
#.#.#.#####.#.#.#.#.###.###.#
#.........#.#.#.#.#.....#...#
#############################
