#############################
#.....#...#S....#...........#
###.#.#.#.#####.###.#.#####.#
#...#...#.....#...#.#.#...#.#
#.#.#############.#.#.#.#.#.#
#.#.#.......#.....#.#.#.#.#.#
#.###.#####.#.#######.#.###.#
#...#.#...#...#.......#...#.#
###.#.#.#.#######.#####.#.#.#
#...#...#.#.....#.#.#...#...#
#.#######.#.###.#.#.#.#######
#.........#...#...#...#.....#
#.###########.#####.###.###.#
#.#.#.........#...#.#...#.#.#
#.#.#.###.#####.###.#.#.#.#.#
#.#.....#.....#.....#.#.#...#
#.#####.#####.###.#####.#.###
#...#.#.#...#...#...#...#...#
###.#.#.#.#.###.###.#.#######
#.#.#.#..E#...#...#.#...#...#
#.#.#.#####.#####.#.#.#.#.#.#
#.#.#.......#.....#.#.#...#.#
#.#.#########.#####.#######.#
#.............#.............#
#############################
