#############################
#.#...................#.....#
#.#.#############.#####.###.#
#.#...#.......#.#.#...#.#...#
#.###.#.#####.#.#.#.#.#.#.###
#.#...#...#...#.#...#.#.#...#
#.#.#####.#.###.#####.#.###.#
#.#.#.....#...#.....#.....#.#
#.#.#.#.#####.#.#.#########.#
#.#.#.#.#.....#.#.....#.....#
#.#.###.#.###########.#.#####
#...#...#.........#...#.....#
#.###.###.#######.#.#######.#
#.#...#...#.....#.#.......#.#
#.#.#.#####.###.#.#.###.#.#.#
#.#.#.#S....#.#.#.#.#...#.#.#
#.#.#########.#.#.###.#####.#
#.#.....#.......#...#.#.....#
#.###.#.#.#########.#.#.#####
#...#.#.#.....#.......#.....#
###.###.#####.#############.#
#.#...#.....#.......#.....#.#
#.###.###.#.#######.#.###.#.#
#...#...#.#.#...#.#.#.#.#...#
#.#####.#.#.#.#.#.#.#.#.###.#
#.........#...#...#E..#.....#
#############################
