#############################
#...........................#
#####.#.#.#####.#.#.#####.#.#
#...#.#.#.....#.#.#.....#.#E#
###.###.#.###.#####.#######.#
#.#...#.#...#.....#.......#.#
#.#.#.#.#.###.###.#########.#
#.#.#.#.#...#...#.........#.#
###.###.#.###.###.#####.#.#.#
#.#...#.#...#...#.....#.#.#.#
###.#.#.#.###.#####.#.#.###.#
#.#.#.#.#...#.....#.#.#...#.#
###.#######.#####.#####.#####
#.#.......#.....#.....#.....#
###.#.#.#.#.#########.#.#.###
#.#.#.#.#.#.........#.#.#...#
#####.###.#.###.#.###.#######
#...#...#.#...#.#...#.......#
#.#.###.#.#.###.###.#####.###
#.#...#.#.#..S#...#.....#...#
#######.#.###.#.###.#########
#.....#.#...#.#...#.........#
#.#.###.#.#.###.#########.###
#.#...#.#.#...#.........#...#
#.#####.#.#.#.#.###.#.###.###
#.....#.#.#.#.#...#.#...#...#
#############################
