#############################
#...........................#
#.#########.#########.#####.#
#.........#.........#.....#.#
###.###########.#.#.#.###.###
#.#...........#.#.#.#...#...#
#####.###.#.#.###.#.###.###.#
#...#...#.#.#...#.#...#...#.#
#.#####.###.#.#####.#.#.#.#.#
#.....#...#E#.....#.#.#.#.#.#
#.###.#.#.#####.#.#.#########
#...#.#.#.....#.#.#.........#
#.###.#.#.#.#######.#.#####.#
#...#.#.#.#.......#.#.....#.#
#.###.#####.#######.#######.#
#...#.....#.......#..S....#.#
#.#.#.#.#.#.#.#.#.###.###.#.#
#.#.#.#.#.#.#.#.#...#...#.#.#
#########.#.#.#.#.###.#.#####
#.......#.#.#.#.#...#.#.....#
###.#######.#.#.#.#.###.#.###
#.#.......#.#.#.#.#...#.#...#
#############################
