#############################
#...........................#
#####################.###.###
#...................#...#...#
#.#.#########.###.###.#.###.#
#.#.........#...#...#.#...#.#
#########.#.###.###.#.###.###
#.......#E........#.#...#...#
#.#.#######.#.#.#.#.###.#####
#.#.......#.#.#.#.#...#.....#
#####.###.###.#.###.#.#.###.#
#...#...#...#.....#.#.#...#.#
#########.###.#.#.###.#.#.###
#.......#...#...#...#.#.#...#
#.###.###.#####.#.#####.#####
#...#...#.......#.....#.....#
#############.#.#.#.#.#.###.#
#...........#.#S#.#.#.#...#.#
#########.#####.#.#.#.#######
#.......#.....#.#.#.#.......#
#.#######.#######.###.###.#.#
#.......#.......#...#...#.#.#
#######.###.#.###.#########.#
#.....#...#.#...#.........#.#
#############################
