#############################
#.............#...#.....#...#
#.###.#.#.###.#.###.###.#.###
#.#...#.#...#...#.#.#...#...#
#.#####.#####.###.###.#####.#
#.#...#.#.......#.#.........#
#.###.#######.###.#####.#####
#.#.#.#.#.#...#.....#...#.#S#
#.#.#.#.#.#.#.#.###.#.###.#.#
#.....#.#...#.#.#...#.....#.#
#.#.###.#######.#####.#.###.#
#.#...#.#...........#.#.#...#
#.#####.###.#########.#.#.###
#.........#.#.....#...#.#...#
###.###.###.#.#.#.#.###.###.#
#...#...#.....#.#...#.#.#...#
###.###.#.###.###.###.#.#.#.#
#...#.......#...#.#.......#.#
###.#.###.#######.###.#.###.#
#...#E..#.....#.....#.#...#.#
#############################
