#############################
#...........................#
###.###.###.###.#############
#.#...#...#...#.............#
#.#.#.###.#.#######.#.#######
#.#.#...#.#.......#.#.......#
###.#.#.#.#.#.#.#.#.#######.#
#.#.#.#.#.#.#.#.#.#.......#.#
#.#######.#.#.#.###.#.###.###
#.......#.#.#.#...#.#...#...#
###########.#.#######.#####.#
#..E......#.#.......#.....#.#
#.#####.###.#.#####.#.#####.#
#.....#...#.#.....#.#.....#.#
#.#.#.#.#.###.#.#.###########
#.#.#.#.#...#.#.#...........#
#.#.###.#######.#.###.#.#.###
#.#...#.......#.#...#.#.#...#
#.###########.#.#############
#...........#.#.............#
###########.#####.#######.#.#
#.........#..S..#.......#.#.#
#####.#.#.#.#.#######.###.#.#
#...#.#.#.#.#.......#...#.#.#
###.#.#.#.#.#########.#.###.#
#.#.#.#.#.#.........#.#...#.#
###.###.#.###.###.#########.#
#.#...#.#...#...#.........#.#
#############################
