#############################
#.............#...#...#.....#
#.#######.#####.#.#.#.#.###.#
#.......#.......#...#.....#.#
#######.###################.#
#...#...#.......#.....#.....#
#.#.#.#######.#.#####.#.#####
#.#.#.........#...#...#.#...#
#.#.#############.#.###.#.#.#
#.#.#..E........#.#.#...#.#.#
#.#.#.#####.#####.#.#.#####.#
#.#...#.....#...#.#.#..S#...#
#.#.#########.#.#.#.#####.###
#.#.#...#.....#.#.#.........#
#.#.#.#.#.#####.#.#########.#
#.#.#.#...#.....#...#.....#.#
#.###.#####.#######.#.###.#.#
#...#...#.#...#...#...#.#...#
###.###.#.###.#.#.#####.###.#
#...#...#...#...#...#.....#.#
#.#.#.###.#.#######.#.#.###.#
#.#.#.#...#...#...#...#.#...#
#.###.#.#######.#.#####.#.###
#...#.#.......#.#.......#...#
###.#.#######.#.###########.#
#...#...#...#.#.#.....#...#.#
#.#####.#.#.#.#.#.###.#.#.#.#
#.........#...#.....#...#...#
#############################
