#############################
#...#.....#.............#...#
#.#.###.#.#.#######.###.#.#.#
#.#...#.#...#...#...#.#.#.#.#
#.###.###.###.#.#.###.#.###.#
#...#...#.....#.#...#.#.....#
###.###.#######.###.#.#####.#
#...#.#.#.......#...#.....#.#
#.###.#.#.#####.#.###.###.#.#
#...#.#.#...#S#.#...#.#...#.#
###.#.#.#####.#####.###.#.#.#
#.#...#.....#.#.....#...#.#.#
#.###.#####.#.#.#####.###.#.#
#...#.#...#...#...#...#...#.#
#.###.#.#.#######.###.#####.#
#...#...#...#.....#...#.....#
###.#######.#.#####.###.#####
#...#.....#.#.....#.#E..#...#
#.###.#.###.#####.#.#.###.#.#
#.....#...........#.......#.#
#############################
