#############################
#.#.....#...#.........#.....#
#.#.#.#.###.#.#######.#.#.###
#...#.#...#.#.#.....#.#.#...#
#.###.###.#.#.#.###.#.#.###.#
#...#...#...#...#...#.#.#.#.#
###.###.###.#####.###.#.#.#.#
#...#...#...#...#...#...#.#.#
#.###.#######.#.###.#####.#.#
#...#.........#.#...#.....#.#
#########.#####.#.###.#####.#
#.......#.....#...#.......#.#
#.#####.###.#####.#######.#.#
#...#.#...#.#...#.......#.#.#
#.#.#.###.###.#.#######.#.#.#
#.#E#...#.....#.#.........#.#
#.#.#.#.#######.###.#######.#
#.#.#.#.......#...#...#.....#
#.#.#.#####.#####.###.#.#####
#.#.#.#...#.......#...#.....#
#.#.#.#.#.###########.#####.#
#.#.#...#...#.......#.....#.#
#.#.#######.#.#####.#####.#.#
#.#.....#.....#...#...#...#.#
#.#####.#######.#.###.#####.#
#.....#......S#.#...........#
#############################
