#############################
#S#.......#.......#...#.....#
#.#.#.#######.#######.#.#####
#...#...#...#.....#.........#
###.#.#.#.###.#.###.#####.###
#...#.#...#...#.......#.....#
###.#####.#######.###.###.###
#...#.....#...#.#.#.....#.#.#
#.###########.#.###.#.#####.#
#...#.#.........#.#.#.#.....#
#.###.###.#.#.###.###.#.###.#
#...#.....#.#.#.........#...#
###.#.###.###.#.#######.#####
#.....#.#...#.....#.#.......#
#.#.###.###########.#######.#
#.#.#.#.........#.....#.#.#.#
###.#.###.###########.#.#.#.#
#....E..#.........#.......#.#
#.###.###.#.#####.#.#.###.#.#
#.#.#...#.#...#...#.#...#...#
#.#.#.#.#.#.#.#.#.#.###.#####
#.#...#...#.#.#.#.#.#.......#
#############################
