#############################
#...........................#
###.#.###.###.#.#.#.#.#######
#.#.#...#...#.#.#.#.#.......#
#.#######.###.#####.#.#.###.#
#.......#...#.....#.#.#...#.#
#.#.#.###.#.###.#########.#.#
#.#.#...#.#...#.........#.#.#
#######.#.#.###.###.#######.#
#.....#.#.#...#...#.......#.#
#####.#.###.#.###.#.#.#.#.###
#...#.#...#.#...#.#.#.#.#...#
#######.#######.#.#.#.#.###.#
#.....#.......#.#.#.#.#...#.#
#####.#.#.#########.#.#.#.###
#...#.#.#.........#.#.#.#...#
#.#####.#######.###.#.###.###
#.....#.......#...#.#...#...#
###.###.###.#.###.#####.#####
#....................E#.....#
#.#.#######.#.###.#######.#.#
#.#.......#.#...#.......#.#.#
#.#.#####.#.#.#.###.#######.#
#.#.....#.#.#.#...#.......#.#
#.#.#.#.#######.#####.###.###
#S#.#.#.......#.....#...#...#
#.#.#.#.###.#.#.#########.###
#.#.#.#...#.#.#.........#...#
#############################
