#############################
#.#...#...........#.........#
#.#.#.#.#####.###.#.#.#####.#
#.#.#.......#.#.#.#.#.#.....#
#.#.#########.#.#.#.#.#######
#...#...#...#.#...#.#.......#
#.###.#.#.#.#.#.###########.#
#.#.#.#...#...#.......#.....#
#.#.#.#########.#####.#.#####
#...#.#...#.#...#...#...#...#
#####.#.#.#.#.###.#.#####.#.#
#.....#.#.#...#...#.......#.#
#.#####.#.###.#.###########.#
#.#...#.#...#.#...#.....#...#
#.#.#.#.###.#.###.#.###.#.#.#
#...#.....#.#...#.#...#.#.#.#
###########.#####.###.#.#.###
#...#E......#...#.....#.#...#
#.#.#.#.#####.#.#######.###.#
#.#...#.#...#.#...#.....#.#.#
#.#######.#.#.#.#.#.#####.#.#
#.#.....#.#...#.#.#.#...#.#.#
#.#.###.#.#####.###.#.#.#.#.#
#.....#.......#.......#...#S#
#############################
