#############################
#.#.#.#...#...#..E#.....#...#
#.#.#.#.###.#.###.#.#.#.#.#.#
#...#...#.#.#.#.....#.#...#.#
#.###.###.#.###.###.#######.#
#...#.......#...#...#...#...#
###.#####.#######.###.#####.#
#.........#.......#.........#
#.#.###.#####.###########.###
#.#.#.#...#.....#.......#.#.#
#####.#.#####.#.#.###.###.#.#
#...#.........#.#...#.#...#.#
###.###.#######.#####.###.#.#
#.#.#.......#.#.....#.......#
#.#.#.#.#.###.###.#.#.#######
#.#.#.#.#.#.#.#.#.#.#.....#.#
#.#.#.###.#.#.#.#######.###.#
#.....#.........#...........#
#.###.###.#####.#########.#.#
#...#.#...#.....#.........#S#
#############################
