#############################
#S#.#.......#...#.....#.#...#
#.#.#.###.#####.#.#####.###.#
#.#...#.#.#...#...#.....#...#
#.#.###.#.###.###.#.###.###.#
#.#.#...#.....#...#.#.......#
#.#####.#.#####.#####.#####.#
#.#.#...#.#.......#.....#...#
#.#.#.###.###.###.###.#.#.#.#
#.#.....#...#.#...#...#.#.#.#
#.###.#.###.#.###.###.###.#.#
#.#.#.#.....#.#...#.....#.#.#
#.#.#.###.###.###.#########.#
#.....#.....#.#.#..........E#
###.#.#.#####.#.#.#####.#.###
#...#.#.#.......#.....#.#...#
#####.#.###.#.###########.#.#
#...#.#.....#.#.#.....#...#.#
###.#.#######.#.###.#.#.#.###
#.....#.#...#.....#.#...#...#
#####.#.#.#.#########.###.###
#...#.#.#.#...#.#.#...#.#...#
#.#.#.#.#####.#.#.###.#.#####
#.#...............#.........#
#############################
