#############################
#.....#.............#.......#
#.###.#.###.#######.###.###.#
#...#.#.#.#.....#.#.....#...#
###.###.#.#####.#.###.#####.#
#...#...#...#...#.....#...#.#
#.#.#.###.#.#.#########.#.###
#.#.#.#...#.#...........#...#
#.###.#.#.#.###############.#
#.....#.#.#.#...........#...#
#.#######.#.#######.#.###.#.#
#.#.....#.#...#...#.#...#.#.#
#.###.#.#.###.#.#.#####.#.#.#
#.#...#...#.#.#.#.......#.#.#
#.#.#######.#.#.#####.###.#.#
#.#.#.......#...#...#.#...#.#
#.#.#.###########.###.#.###.#
#.#.#.................#.#...#
#.#.#.#################.#.###
#...#..E............#S..#...#
#############################
