#############################
#...........#...#...#.......#
#.#######.#.#.#####.#####.###
#.#.#.....#...........#.#...#
#.#.#######.#########.#.#.###
#.#...#.#...#...#...#.....#.#
#.###.#.#####.###.###.#.#.#.#
#.#.#.........#...#...#.#...#
#.#.###.#.#.#.###.#####.#####
#.#...#.#.#.#...#.#.........#
###.#####.#####.#.#.###.###.#
#S......#.#.....#...#...#...#
###.#.###.#########.###.#.#.#
#...#.........#...#.#...#.#.#
#####.#.#####.#.###.#######.#
#.....#...#...#.#.#...#...#.#
###.#.#########.#.#.###.#####
#...#.....#...#.....#.......#
###.#####.#.#.#####.#.###.###
#...#.#...#.#.........#..E#.#
#.#.#.#.#.#.#.#######.#####.#
#.#.#...#...#.....#.........#
#############################
