#############################
#...........................#
#.#.#.#.###.###.###.#####.#.#
#.#.#.#...#...#...#.....#.#.#
#.#.###.###.#.#.###.#.#.#.###
#.#...#...#.#.#...#.#.#.#...#
###.###.#.#.#######.#.#.#####
#S.................E#.#.....#
#.#.#####.#.###.#.#.#.#####.#
#.#.....#.#...#.#.#.#.....#.#
#.#####.#######.###.###.#.#.#
#.....#.......#...#...#.#.#.#
#.#####.#.#.#.###.###.#.#####
#.....#.#.#.#...#...#.#.....#
###.###.#####.#.#.###.###.###
#.#...#.....#.#.#...#...#...#
#.#####.#.#.###.#####.#####.#
#.....#.#.#...#.....#.....#.#
###.#.#.###.#.#####.#########
#.#.#.#...#.#.....#.........#
###.#####.###.#.###.###.#.###
#.#.....#...#.#...#...#.#...#
#.#.#.###.#####.#.#######.###
#.#.#...#.....#.#.......#...#
#############################
