#############################
#...........................#
#.###.###.#.###############.#
#...#...#.#...............#.#
###.#.#####.#.###.###.#.#.#.#
#.#.#.....#.#...#...#.#S#.#.#
###.#.#.#.###.#####.#.#.###.#
#.#.#E#.#...#.....#.#.#...#.#
#.#.#.#.#.###.#.#.#########.#
#.#.#.#.#...#.#.#.........#.#
#######.###.#######.###.#####
#.....#...#.......#...#.....#
#.#.#####.###.###.###.#.###.#
#.#.....#...#...#...#.#...#.#
#.###.###.#.#.#.#######.#.#.#
#...#...#.#.#.#.......#.#.#.#
###.#.#.#######.#.###.#.#####
#.#.#.#.......#.#...#.#.....#
#.#####.#.###.###.#######.###
#.....#.#...#...#.......#...#
#############################
