#############################
#.....#S#.....#.....#...#...#
#.###.#.###.#.###.#.#.#.###.#
#...#.#.....#.#...#...#...#.#
###.#########.#.#########.#.#
#...#.......#...#.......#.#.#
#.###.###.#.#####.#.###.#.#.#
#...#...#.#.#...#.#.#...#.#.#
###.###.#.###.#.#.#.#.###.#.#
#.....#.#.....#...#.#...#.#.#
#.#####.###########.#####.#.#
#.......#.#.......#.#...#...#
#.#######.#.#.#####.#.#.###.#
#.......#...#...#...#.#...#.#
#######.###.###.#.###.###.#.#
#.....#...#.#...#.....#...#.#
#.#######.###.#########.###.#
#.#.....#...#.....#...#.....#
#.#.#.#####.#.#.#.#.#.#######
#.#.#E......#.#.#...#.#.....#
#.#.###########.#####.###.#.#
#...............#.........#.#
#############################
