#############################
#...........................#
#.###.###.#######.#.#.#.#.#.#
#...#..............E#.#.#.#.#
#.#####.###.#.#######.#####.#
#.........#.#.......#.....#.#
###.#.#.#######.###.#.#.#.###
#.#.#.#.......#...#.#.#.#...#
#.#.###.#.###.#.#####.#.#####
#.#...#.#...#.#.....#.#.....#
###.###.###.#.#####.#####.#.#
#.#.......#.#.....#.....#.#.#
#.#####.#####.#.#.###.#######
#...........#.#.#...#.......#
#.#####.###.#.#.###.###.###.#
#......S..#.#.#...#...#...#.#
#.#.#.#.#.###.###########.###
#.#.#.#.#...#...........#...#
#.#####.#.#.#.#.#.###.#.#####
#.....#.#.#.#.#.#...#.#.....#
#.#####.#########.#####.#.###
#.....#.........#.....#.#...#
#############################
