#############################
#.#.....#.........#...#...#S#
#.#.###.###.#.#.#.#.###.###.#
#.#.#.#.#.#.#.#.#.........#.#
#.#.#.###.###.#.###########.#
#.#.#.....#.#.#.#...#.......#
#.#.#.#.#.#.#.#.###.#######.#
#.....#.#.....#.#.....#.#...#
#########.###.#####.###.###.#
#.........#...#.......#.....#
#.#####.#######.#####.#.###.#
#.....#.......#.#.#.......#.#
###.###.#.###.#.#.#####.#.#.#
#.#.#...#...#.#.#...#...#.#.#
#.#.#.#####.###.###.#.###.###
#...#.....#...#.#.#...#...#.#
###.#####.#.#.###.###.#.###.#
#.....#.#.#.#...#.#...#.#...#
#.#.###.#####.#.#.#.###.#.#.#
#.#.#.#...#...#.#.....#...#.#
###.#.###.#####.###.###.#.###
#...#.......#.#.....#...#...#
###.#.#.#.#.#.###.#.#######.#
#...#.#.#.#.....#.#.#.#.....#
#.#.#.#.#.#.#########.#.#####
#.#...#.#.#...#.#.........#.#
#.#.###.#.#.###.###########.#
#.#.#...#.#.#..E..#.....#...#
#.###.###.#####.###.#.###.#.#
#...#.#.............#.....#.#
#############################
