#############################
#...........................#
#########.#######.###.#.#.###
#.......#.......#...#.#.#...#
###.#.#.#.###.#.#.###.#.#.###
#.#.#.#.#...#.#.#...#.#.#...#
#######.#.#.#####.###.###.#.#
#.....#S............#...#.#.#
###.#####.###.#####.#####.#.#
#.#.....#...#...........#.#.#
#.#.###.###.#######.#.#.#.#.#
#.#...#...#.......#.#.#.#.#.#
#####.###.#.#.#.#.#.#.#######
#...#...#.#.#.#.#.#.#.......#
#.#.###.#.#########.#########
#.#...#.#.........#.........#
#######.###.#######.#.#####.#
#.....#...#.......#.#.....#.#
###.#.###.#.###.###.#.###.#.#
#.#.#...#.#...#...#.#...#.#.#
#.###.#########.#.#.###.#.###
#...#.........#.#.....#.#...#
#####.#.###.#.###.#.#.###.###
#...#.#...#.#...#.#.#...#...#
#.###.#.#.#.#.#.#.#.#.###.#.#
#...#.#.#.#.#.#.#.#E#...#.#.#
#.###.#.#.#.###############.#
#...#.#.#.#...............#.#
#.#.#.#####.#.#.#######.###.#
#.#.#.....#.#.#.......#...#.#
#############################
