#############################
#.....#S....#.......#.#.....#
###.#.#####.#.#.#.#.#.###.#.#
#.#.#.#.#.#...#.#.#.......#.#
#.#.#.#.#.#########.#####.###
#.#.#.#.....#...#.......#...#
#.#.#####.###.###.###.#####.#
#.#...#.....#.#...#.......#.#
#.###.#.#####.#.###.#.#######
#.......#...#...#...#.......#
#.#.###.###.#.#.#.#####.#.#.#
#.#...#...#.#.#.#...#.#.#.#.#
#.###.###.#.###.#.###.#.###.#
#.#.#...#...#...#.#.......#.#
###.#######.###########.#.#.#
#...#.#.....#.#...#.....#.#.#
###.#.#.#####.###.#.#.#####.#
#.....#...........#.#E..#...#
#.###.###.###.#.#.#.#.#######
#...#.#.#...#.#.#...#.#.....#
#.#####.#.###########.#.###.#
#.....#...#...#.....#.....#.#
#.#.#####.###.#.#######.#.###
#.#...#.......#.#.#...#.#...#
###.#####.###.#.#.#.#.#######
#.....#...#.......#.#.#.....#
#.#.#######.#####.#.###.###.#
#.#...#...#.#.........#.#.#.#
###.#.#.#.#.#.#####.#.#.#.#.#
#...#...#...#.#.....#.....#.#
#############################
