#############################
#.#.........#...............#
#.#.#######.#.#####.#######.#
#.#.......#...#.....#.....#.#
#.#######.#####.#.#######.#.#
#.........#.#...#.#.....#...#
#.#########.#.#####.###.#####
#...#E......#.......#.#.#...#
###.###.#############.#.#.#.#
#.#...#...............#...#.#
#.###.#.#########.###.#####.#
#...#.#...#.#...#.#...#.#...#
#.#.#.###.#.#.#.#.#.###.#.###
#.#.#.#.#.#.#.#...#.#...#...#
#.#.#.#.#.#.#.#####.#.###.#.#
#.#...#.#...#.....#...#S#.#.#
#.#####.###.#####.###.#.###.#
#.#...#...#.#.....#...#...#.#
#.#.#.###.#.#.#####.#####.#.#
#...#...#...#.#...#.#...#...#
#######.#####.#.#.#.#.#.#####
#.....#.....#.#.#.#.#.#.....#
#.###.#####.#.#.###.#######.#
#...#.....#...#...#.........#
###.#####.#######.#########.#
#...#...#.#.......#.......#.#
#.###.###.#.###.###.###.#.#.#
#...#.#...#.#.#.#...#...#.#.#
###.#.#.###.#.#.#.###.#####.#
#.....#.......#.....#.......#
#############################
