#############################
#..............S............#
#######.#####.#.#.###.###.#.#
#.....#.....#.#.#.......#.#.#
#.#.###.#.#.#####.###.#####.#
#.#...#.#.#.....#.........#.#
#.###.###.#.#####.#.#.#.###.#
#...#...#.#.....#.#.#.#...#.#
#.#.#.#####.#.#######.#####.#
#.#.#.....#.#.............#.#
#.#########.###.#.#.#.#.#####
#.........#...#.#.#...#.....#
#.#.#.###.#####.#.#.#.###.###
#.#.#...#.....#.#.#.....#...#
#.#######.#.#.#.###.#.#######
#.......#.#.#.#...#.........#
#.#####.#.###########.###.#.#
#.....#.#...............#.#.#
#.#.#####.#.###.#####.#.###.#
#.#.....#.#...#.......#...#.#
#########.###.#.#####.#.#.###
#.......#...#.#......E#.#...#
#######.#.###.#.#.#.#######.#
#.....#.#...#.#.#.#.......#.#
#.#.#####.###.#####.#####.###
#.#.....#...#.....#.....#...#
#.###.#.#####.#.#.#.#####.###
#...#.#.....#.#.#.#.....#...#
#########.#############.#.###
#.......#.............#.#...#
#############################
