#############################
#..E..#.....#.......#.....#.#
#.#####.#.#.#.#####.#.#.#.#.#
#.#.....#.#...#...#.#.#.#...#
#.#.#####.#.###.#.#.###.###.#
#.#...#...#.#...#.#.#...#...#
#.###.#.#####.###.#.#.###.###
#.....#.......#...#...#.#...#
#.#########.###.#######.###.#
#.....#...#...#.....#...#...#
#####.#.#.###.#####.###.#.###
#.....#.#...#.#...#...#...#.#
#######.###.###.#.###.#.###.#
#.....#.#.......#.....#.....#
#.###.#.#.#################.#
#.#.....#.#.....#.....#.....#
#.#########.###.#.###.#.#####
#.#...........#.#.#.#.#...#.#
#.#.###########.#.#.#.###.#.#
#...#...#.....#.#.#.#.......#
#.###.###.###.#.#.#.#######.#
#.#...#...#.....#.....#..S#.#
#.###.#.#.###########.#.#####
#.....#.#.#...#...#...#.....#
#.#####.###.#.#.#.#########.#
#.#.....#...#...#.#.........#
#.#.###.#.#######.#.#########
#.#...#.#.#.....#.#.#.......#
#.###.###.###.#.#.#.#####.#.#
#...#.........#.#.........#.#
#############################
