#############################
#..E#...#.#...#...#.........#
#.#.#.###.###.#.#.#####.###.#
#.#...#.....#...#.....#.#.#.#
###.###.#####.###.###.#.#.###
#...#...#.#.....#.#.........#
#.###.###.###.###.#.#.#.###.#
#.#...#.......#...#.#.#...#.#
#.#.#####.#.###.###.#######.#
#.#...#...#.#...#.....#...#.#
#.###.#.#######.###.###.#.###
#.#.....#.#...#.#.......#.#.#
#.###.###.#.###.#.#.###.#.#.#
#.....#.....#.#.#.#.#...#.#.#
#.#.#.###.#.#.#.#.#######.#.#
#.#.#...#.#...#.#.#...#...#.#
###.#.#.#####.###.#.#######.#
#.#.#.#...#.....#.......#...#
#.#.#######.#######.#.###.#.#
#.....#.........#...#...#.#.#
#####.###.#.#.#####.#.###.#.#
#.#.#...#.#.#...#.#.#...#.#.#
#.#.###.#.###.###.#.#.###.###
#.......#.#.#.......#.......#
#.###.#####.#.#########.###.#
#...#.#.....#.#...........#.#
#.#.###.#.#######.#.#.###.#.#
#.#.....#.#.......#S#.#...#.#
#.#########.###############.#
#...#.....................#.#
#############################
