#############################
#...........................#
###.#.#.#.#.#.###.#.#####.#.#
#.#.#.#.#.#.#...#.#.....#.#.#
#.###.###.###.#.###.###.#.###
#...#...#...#.#...#...#.#...#
#####.#.###.###.###.#.#.#####
#...#.#...#...#...#.#.#.....#
###.#.###.#.#####.###.#.#####
#.#.#...#.#.....#...#.#.....#
#.#.#####.#####.#####.#.#.#.#
#.#.....#.....#.....#.#.#.#.#
#.#.#.#.#.###.#########.###.#
#.#.#S................#...#.#
#########.###.#.#.#####.#.#.#
#.......#...#.#.......#.#.#.#
#####.#.#########.###.###.###
#...#.#.........#...#...#...#
#.###.###.#.###.#.#####.#.###
#...#...#.#...#.#.....#.#...#
#.###.#.#.#.###.#.#.###.#.###
#...#.#.#.#...#...#...#.#...#
###.#####.###.#.#.#####.#.###
#.#.....#...#.#.#.....#.#...#
#.#.#######.#.#.#.###.###.#.#
#.#.......#.#.#.....#...#.#.#
#######.#.#.#####.#####.###.#
#.....#.#.#.....#E....#...#.#
###.#.#.#.#.#####.###.#.#.#.#
#.#.#.#.#.#.....#...#.#.#.#.#
#############################
