#############################
#.#.........#.....#.........#
#.#.###.#####.#.###.###.#####
#.....#.......#...#...#.....#
#######.#########.###.#####.#
#.....#.....#...#.........#.#
#.###.#####.#.#############.#
#.#...#...#...#...........#.#
#.###.#.#.###.#.#########.#.#
#...#.#.#.#...#.#...#.....#.#
###.#.#.###.###.#.#.#.#####.#
#...#.#.......#.#.#.........#
#.###.#.#######.#.###########
#.#...#...#.....#.#.#.......#
#.#.#######.#####.#.#.#####.#
#.#.........#...#.#.#.#.#S#.#
#.#############.#.#.#.#.#.#.#
#.#.............#...#...#.#.#
#.#.###.###########.###.#.#.#
#.#.#.#.............#.#.#...#
#.#.#.###############.#.#####
#.#...#...#.....#.....#.#...#
#.###.#.#.#.###.#####.#.#.###
#.#.....#...#.......#.#.#...#
#.#.###############.#.#.#.#.#
#.#...#.........#.....#.#.#.#
#.#####.#######.#.#####.#.#.#
#.#.....#....E#.#.#...#.#.#.#
#.#.#######.#.#.###.#.#.###.#
#...........#.#.....#.......#
#############################
