###############################
#......E........#...#.#.......#
#####.#######.###.###.#.#####.#
#.........#...#...........#.#.#
#.#######.###.#####.#####.#.#.#
#.....#...#.....#...#...#...#.#
###.#.###.#.#.#.#####.#.#.###.#
#.#.#.#.#.#.#.#.#.....#...#.#.#
#.###.#.#########.###.###.#.#.#
#...#.....#...#.#.#...#.#S#...#
#.###.#.#####.#.###.###.#####.#
#.#.#.#...#...............#.#.#
#.#.#.#####.###.#.#####.#.#.#.#
#.............#.#.#.....#...#.#
###############################
