###############################
#....E..#.#...................#
#.###.#.#.#.#####.#.#.#.#####.#
#.#...#.#.......#.#.#.#...#S..#
###.#########.#.#.#####.#####.#
#.....#.....#.#.#...#.#...#.#.#
#.#######.###.#######.#.###.#.#
#.......#...#...#.#...#...#...#
#.#.#####.#.#.###.###.#.###.#.#
#.#...#.#.#.#.....#.#.#.#.#.#.#
#.#.#.#.#.#.#.#.###.#.###.#.###
#.#.#.....#...#.......#.......#
###############################
