###############################
#.......#.#.#...#.#...#.....#S#
#.#.###.#.#.#.###.#.#.###.###.#
#.#.#.#...#.....#.#.#.......#.#
#.#.#.###.#####.#.###.#####.#.#
#.#.#.........#.....#.#.......#
#.#######.#.#.#.#####.###.###.#
#...#...#.#.#.#.#...#...#.#...#
###.#.#########.#.#.#.#########
#.#.#...#.........#.....#.....#
#.#.#.#.#.#.#####.###.#.#.#.#.#
#E#...#...#.....#...#.#.#.#.#.#
#.#####.###.###.###.#####.#.###
#...#.....#.#...#.#.......#...#
###.#.#.#.#.#####.#.#####.#.#.#
#.....#.#.#...#.....#.....#.#.#
###############################
