###############################
#.............................#
#####.#.###.#####.###.#.#######
#...#.#...#.....#...#.#.......#
#.#.#####.###.#.###.#.#########
#.#.....#...#.#...#.#.........#
###.#####.###.#.#.###.#.#.###.#
#.#.....#...#.#.#...#.#.#...#.#
#.#.###.#.#.#.#####.#.#####.#.#
#S...............E#.#.....#.#.#
#.###.###.###.#.#######.#.###.#
#...#...#...#.#.......#.#...#.#
#.###.###.###.#.#####.#####.###
#...#...#...#.#.....#.....#...#
#.###.#.###.#.#########.###.#.#
#...#.#...#.#.........#...#.#.#
###############################
