###############################
#..............E#.....#.#...#.#
#.###.###.#####.#.#####.###.#.#
#...#.#...#.......#...........#
#####.###.#########.#####.###.#
#...#.#...#.......#.#...#.#.#.#
###.###.#.###.###.#.#.#####.#.#
#.......#.#.#...#...#.#...#...#
###.#.###.#.###.#####.#.#.#.###
#...#.#.#...........#...#.#.#.#
###.#.#.###.###.#######.#.#.#.#
#.#.#.#.#.#...#.......#.#.....#
#.#.#.#.#.#############.#.#####
#...#...........#S#.....#.#...#
#.#.#.#####.#.###.#.#.###.#.#.#
#.#.#.....#.#...#...#.#.....#.#
###############################
