###############################
#.#.......#..E..#.......#.....#
#.###.###.#####.#######.#.#.###
#...#.#...............#...#.#.#
###.#####.#########.#####.###.#
#.......#.#.#.....#.#.......#.#
#.#.#####.#.#####.#####.#####.#
#.#...........#.......#.....#.#
###.###.#.#########.#.#.###.#.#
#S..#...#...........#...#.....#
###############################
