###############################
#....E...........S............#
###.#####.#.#.#.###.#.#.#.#.###
#.#.....#.#.#.#...#.#.#.#.#...#
#.#.#.#.#####.#.#.#.###.#.#.#.#
#.#.#.#.....#.#.#.#...#.#.#.#.#
#.###.###.#.#.#.#####.#.#.###.#
#...#...#.#.#.#.....#.#.#...#.#
###########.#.#.#############.#
#.........#.#.#.............#.#
###############################
