###############################
#.#.....#.........#.........#.#
#.#.###.#.#######.###.#####.#.#
#...#...#...#...#.#...#...#...#
#.###.#####.#.#.#.#.###.#.###.#
#.#.#.#S....#.#.#...#...#.#...#
#.#.#.#######.#.#####.#####.###
#...#...#.....#.....#.......#.#
#.###.#.###.#######.#.#######.#
#.#...#...#.#.....#.#...#.....#
###.#####.#.#.#####.###.#.#.#.#
#...#...#...#.....#...#.#.#.#.#
#.#.#.#.#########.###.#.###.#.#
#.#.#.#.........#.....#E#...#.#
#.###.#########.###.###.#.###.#
#...#.#.......#...#...#...#...#
#.#.#.###.###.###.#########.###
#.#.......#.....#.............#
###############################
