###############################
#.#.#.....#E......#.#...#.....#
#.#.###.#.###.#####.#.#####.#.#
#.......#.#.#.....#.........#.#
#####.###.#.#####.###.###.###.#
#.....#...#...#...#.#.#.#..S#.#
###.#######.###.###.#.#.#.###.#
#...........#...........#.#...#
###.#.###############.###.#####
#.#.#...#...#.#.#...#...#...#.#
#.#.###.###.#.#.#.#.#.###.#.#.#
#...#.............#.....#.#...#
###############################
