###############################
#.............................#
#####.###.#.###########.#.#.###
#...#...#.#...........#.#.#...#
#####.#.#.#.###.#.#####.#####.#
#...#.#.#.#...#.#.....#.....#.#
###.#######.#######.#.#.#######
#.#..................S#.......#
#.###.#.#.#####.#####.#.#.#####
#...#.#.#.....#.....#.#.#.....#
#.###.#########.#######.#.#.#.#
#.............#.......#.#.#.#.#
###.#.#.###.###########.#######
#.#..E#...#...........#.......#
###############################
