###############################
#.............................#
###.#.#########.###############
#.#.#.........#..........E....#
#.#.###.#####.#.#.#.#.#.#.#####
#.#...#S....#.#.#.#.#.#.#.....#
#########.#.#.#.###.###.###.#.#
#.......#.#.#.#...#...#...#.#.#
#.#.#.###.###.#####.#.#.#######
#.#.#...#...#.....#.#.#.......#
###.###.###.###.###.#.#.#.#.#.#
#.#...#...#...#...#.#.#.#.#.#.#
###############################
