###############################
#..S..........................#
#####.#####.###.#####.#.#.#####
#...#.....#...#.....#.#.#.....#
###.#######.#.#.###########.###
#.#.......#.#.#....E......#...#
#.#.#########.###.#.###.#######
#.#.........#...#.#...#.......#
#######.###.#.#.###.#.###.###.#
#.....#...#.#.#...#.#...#...#.#
###############################
