###############################
#.........#.....#...........#.#
#.###.###.#.###.#.#####.###.#.#
#...#.#...#.#S..#.#...#...#.#.#
#.###.#####.#######.#.###.#.#.#
#.#...#.....#.......#.#...#...#
#.#.###.#####.#######.#.#######
#.#.#E..#.....#.....#.#.......#
#.#.#.#####.###.#.###.#######.#
#.#.........#...#.............#
###############################
