###############################
#...#...#...............#.....#
#.###.#.#.#.#.###########.###.#
#.....#...#.#.#...........#...#
###########.#.#.###########.###
#...#.......#.#...#.....#S..#.#
#.#.#.###########.#.###.#####.#
#.#...#.......#...#.#.......#.#
#.###.#.#####.#.#####.#####.#.#
#.#...#.#.#...#.#.....#.......#
#.#####.#.#.###.#.#.###########
#.....#...#.....#.#...........#
#.###.###.#######.###########.#
#...#...#.#...#...........#...#
###.###.#.#.#.#############.#.#
#.....#..E..#...............#.#
###############################
