###############################
#.........#.......#.....#.....#
#.#######.###.###.#.###.#.###.#
#.#.....#...#...#.#.#.....#...#
#.#.###.###.###.#.#.#.#########
#.#.#...#.#.#...#...#...#.....#
#.#.#.###.#.#.###########.###.#
#.#.#.#.#...#.#S..........#.#.#
#.#.#.#.#.###.#############.#.#
#...#.#.......#.#.....#.....#.#
#####.#######.#.#.###.#.###.#.#
#.....#.....#...#.#...#.#.#...#
#.###.#.###.###.#.#.#.#.#.#####
#...#.#.#.#...#.#.#.#.#.....#.#
#.#.###.#.###.###.#.#######.#.#
#.#..E......#.....#...........#
###############################
