###############################
#........................S....#
###.#.#####.#####.###.#.#######
#.#.#E....#.....#...#.#.......#
#.#.###.#.#.#.#.#####.###.#.###
#.#...#.#.#.#.#.....#...#.#...#
#.#######.#.###.#.#############
#.......#.#...#.#.............#
#####.#.###########.#.#########
#...#.#...........#.#.........#
#.#.#######.###.#.#.#####.###.#
#.#.......#...#.#.#.....#...#.#
###############################
