###############################
#.......#...#.....#...#.......#
#####.#.#.#.###.#.#.#.#.#####.#
#.....#...#.....#.#.#...#.....#
#.#########.#####.#.#####.#####
#.#...#.....#...#.#.#.#...#S#.#
#.#.#.#####.#.#.###.#.#.###.#.#
#...#.....#.#.#...#.#.#...#.#.#
#.#######.###.###.#.#.###.#.#.#
#.#..E#.#...#.#.#...#...#...#.#
#.#.#.#.###.#.#.#####.#.#####.#
#.#.#...#...#.#.......#.......#
#.#.###.#.###.#############.#.#
#...#...#...................#.#
###############################
