###############################
#.....#...........#...........#
###.#.###.#.#####.#####.#####.#
#...#.....#.#...#.....#...#S#.#
#.###########.#.#####.###.#.###
#.#...........#...#...#...#...#
#.#.#############.#.###.#####.#
#.#...#.....#...#.#.....#...#.#
#.###.###.#.#.#.#.#.#####.#.#.#
#.#...#...#.#.#.#.#.#.....#...#
#.#.###.###.#.#.#.###.#########
#.#.....#...#.#.#.....#...#...#
#.#######.#####.#######.#.#.#.#
#..E....................#...#.#
###############################
