###############################
#......S......................#
#.#.###.#.#######.#.#.###.#.#.#
#.#...#.#.......#.#.#...#.#.#.#
#.#######.#.###.#.###.#.#.#####
#.......#.#...#.#...#.#.#.....#
###.#.#.###.#.#.#########.###.#
#.#.#.#...#.#.#....E....#...#.#
#.#.#.#.#.#.#.#####.#####.#####
#.#.#.#.#.#.#.....#.....#.....#
###############################
