###############################
#.......#.......#.....#...#...#
#.###.###.###.#.###.#.###.#.#.#
#...#...#.#...#.....#....E#.#.#
###.###.#.#.###############.#.#
#...#.#...#.................#.#
#.###.#########.#######.#####.#
#...#.....#.#S#...#...#.#.....#
###.###.#.#.#.#.###.#.#.#.###.#
#.#.#...#...#.#.#...#.#.#.#...#
#.#.#.#####.#.###.###.###.#.###
#.....#.....#.....#.......#...#
###############################
