###############################
#...........#.....#...#.....#.#
#.#######.#.###.#.###.#.###.#.#
#E......#.#.....#.....#.#.#.#.#
#.#####.#.###########.#.#.#.#.#
#.#...#.#...#...#.....#...#.#.#
###.#.#####.#.#.#########.#.#.#
#...#.#...#.#.#.#.....#...#S#.#
#.###.#.#.#.#.#.#.###.#.#####.#
#.#.....#...#.#.#.#...#...#...#
#.###########.#.#.#.#####.#.#.#
#.........#...#...#.#...#...#.#
#.#######.#.#######.#.#.#####.#
#.......#.........#...#.......#
###############################
