###############################
#.........#...........#.......#
#.#######.#.#########.###.###.#
#...#.....#.#.......#..E#.#...#
###.#.#####.#.###.#####.#.#####
#.#.#...#...#...#.......#.....#
#.#.###.###.###.###########.#.#
#.#..S#.#...#.#.#.........#.#.#
#.#####.#.###.#.#####.###.###.#
#.........#...........#.......#
###############################
