###############################
#......................E......#
#########.###.###.#.###.###.###
#.......#...#...#.#...#...#...#
#.###.#.#.#.#.###.###.#.#.#.###
#...#.#...#.#...#...#.#.#.#...#
#.#.#.###.#.#.###.#.###.#.#.###
#.#.#...#S#.#...#.#...#.#.#...#
#.#.###.#.###.###.###.#.#.#.###
#.#...#.#...#...#...#.#.#.#...#
###.#.#####.#.#.#.###.#.###.#.#
#.#.#.....#.#.#.#...#.#...#.#.#
###############################
