###############################
#.............................#
###.#.#######.#.###.#.#.#.###.#
#.#.#.......#.#...#.#.#.#S..#.#
#####.###.###.###########.###.#
#...#...#...#...........#...#.#
#.#.#####.###.#.#.###.###.#.###
#.#.....#...#.#E#...#...#.#...#
#.#.#########.#.#########.#####
#.#.........#.#.........#.....#
#.###########.#####.#######.###
#...........#.....#.......#...#
#.#.###.#.###############.#.#.#
#.#...#.#...............#.#.#.#
###############################
