###############################
#.#...#.....#.......#E#...#...#
#.###.#.#.#####.#.###.###.#.#.#
#.#.#.#.#.....#.#.#.......#.#.#
#.#.#.#.#####.#.#.#.###.#.#.###
#.#.#...#.....#.#.#...#.#.....#
#.#.#.###.###.#.#######.#.#.###
#...#...#.#...........#.#.#.#.#
###.#.#####.#.#.#.#.#.#.#####.#
#S....#.....#.#.#.#.#.........#
###############################
