###############################
#...........#...#.............#
#.#######.#.#.#.#.#######.###.#
#.#.....#.#...#.#.#...#.#...#.#
#.#.###.#.#####.#.#.#.#.###.#.#
#.#.#...#.#.....#.#.#.....#.#.#
#.#.#####.###.###.#.#####.#.#.#
#...#...#...#.#.#.#.#.#...#.#.#
#.###.#.###.#.#.#.#.#.#.###.#.#
#.#...#.....#...#.#.#.#.#.#.#.#
###.###.#######.#.#.#.#.#.#.###
#...#.#.#...#...#...#.#.#.#...#
#.###.#.#.#.#.#######.#.#.###.#
#.#...#.#.#.#.#.......#.#.#..E#
#.###.#.#.#.###.###.###.#.#.#.#
#...#...#.#...#.#.#.......#.#.#
#.#.#####.###.#.#.#########.#.#
#.#.........#.....#S........#.#
###############################
