###############################
#.#.....#.....#...............#
#.#.#.###.###.#.#######.#####.#
#...#.....#...#.......#.#E..#.#
#.#########.#####.#####.#.###.#
#.#.#.......#.....#.....#.....#
#.#.#.#######.#####.###########
#.#.#S#...........#...........#
#.#.#########################.#
#.#...#...#.....#.....#.....#.#
#.#.#.#.#.#.###.#.###.#.###.#.#
#...#...#...#.....#.....#.....#
###############################
