###############################
#.............................#
#.#####.#.#.#.#.#.#.#.###.###.#
#.....#.#.#.#.#.#.#.#...#...#.#
###.###.###.###.#.#.#.###.#.#.#
#.#...#...#...#.#.#.#...#.#.#.#
#####.#.#.###.###.#.#.#####.#.#
#...#.#.#...#...#.#.#.....#.#.#
#.#.#.###.###.#.#.#.###.###.#.#
#.#.#...#...#.#.#.#...#...#.#.#
#.#######.#.#####.#.#####.#.#.#
#....S......................#.#
#.#.#.#.#.#######.###.#.###.#.#
#.#.#.#.#.......#...#.#...#E#.#
###.#.#.#.###########.###.#.###
#.#.#.#.#...........#...#.#...#
###############################
