###############################
#.....#...#.#.......#.........#
#####.#.###.###.#####.#.#######
#.........#.#.#.#...#.#.#...#.#
#.###.#.#.#.#.#.#.#####.###.#.#
#...#.#.#.#...#.....#..E..#...#
###.#####.###.#.#.#.###.#.#.#.#
#.....#.#.......#.#.#.#.#...#.#
#.###.#.#.#####.#####.#.#.#.#.#
#.#.#...#...#.....#.....#.#.#.#
#.#.#####.#######.#.#####.###.#
#.#.#...#.#.#...#...#.#.#.#.#.#
###.#.###.#.#.###.#.#.#.#.#.#.#
#.#...#.....#.....#.#...#...#.#
#.#.#####.#.#.#########.#.###.#
#.........#.#.......#...#.#...#
###.#####.#####.###.#.#.#######
#.......#.#.......#...#......S#
###############################
