###############################
#.............................#
#.#####.#.#.#####.#####.#.#.###
#..............E#.....#.#.#...#
###.#.#.#.#########.#.#.###.###
#...#.#.#.........#.#.#...#...#
###.###.#.###.#.###.###.#.#.#.#
#.#...#.#...#.#...#...#.#.#.#.#
###.#####.###.###.###.###.#.###
#.#S....#...#...#...#...#.#...#
###.###.#.#.###.###.#.###.###.#
#.#...#.#.#...#...#.#...#...#.#
###.###.###.#######.#.#.###.#.#
#.#...#...#.......#.#.#...#.#.#
#.#########.#.###.#####.#.###.#
#.........#.#...#.....#.#...#.#
#.#########.#.#.#####.#.###.###
#.........#.#.#.....#.#...#...#
###############################
