###############################
#...............#.............#
#.###.#.###.###.#.###.#.###.###
#.#...#.#...#.......#.#...#...#
#.#####.#########.#########.#.#
#.#.#.....#...#.#.....#.#...#.#
###.#.#######.#.#######.#.#.#.#
#..E....#...#.#.....#.#.#.#.#.#
###.#.###.#.#.###.#.#.#.#.#.#.#
#...#.#...#.#...#.#.....#.#.#.#
#####.###.#.###.#.#######.###.#
#...#.#...#.#.#...#.#.....#...#
#.###.#.#####.#.###.#.#.#####.#
#.#.......#...........#.#...#.#
#.#.#####.#.###.#####.###.###.#
#.......#.#S#.......#.#.......#
###############################
