###############################
#.........#.....#.....#.....#.#
#.#.#####.###.#.###.#.###.#.#.#
#.#...#.#.....#...#.#...#.#...#
#.###.#.#########.#.###.#.###.#
#...#.#.............#.....#.#.#
###.#.#.#############.#####.#.#
#.#.#.#.#...#...#.....#S#.....#
#.#.#.#.#.#.#.#.#.#####.#######
#...#.#.#.#.#.#.#.....#.......#
#.###.###.#.#.#.#############.#
#E..#.....#...#...............#
###############################
