###############################
#.........#.......#...........#
#.#.#####.#.#######.###.#####.#
#.#.....#.#.......#...#.#.....#
#.#####.#.#######.###.#.#.#####
#...#...#.#.......#...#.#...#S#
#####.###.#.#.#####.###.#####.#
#...#...#...#E#...#...#.......#
#.#.###.#######.#.###.#########
#.#...#.........#...#.#.....#.#
#.###.#########.#.#.#.#.###.#.#
#.#...........#.#.#.#...#...#.#
#.###########.#.#.#######.###.#
#.#.........#.#.#.#...#...#...#
#.#.#######.#.###.#.#.#.#####.#
#...#.......#.....#.#...#.....#
#.###.#############.#####.###.#
#...#.....................#...#
###############################
