###############################
#...#...........#.........#...#
#.#.#.#######.###.###.#.#.###.#
#.#...#.....#.....#.#.#E#.....#
###.#####.#.#####.#.#######.###
#.#...#...#.......#...#.....#.#
#.#.#######.#.#####.#######.#.#
#.#...#.#...#.#.......#...#...#
#.###.#.###.###.#####.###.#.###
#...#...#.....#.....#.#...#...#
#.#####.#.#.#.#.#######.#######
#...#.#.#.#.#.........#.#.....#
###.#.#.#.###.#######.#.#####.#
#.#.....#.#.#...#...........#.#
#.#.#####.#.###.#.#####.#.###.#
#...#.........#.#...#...#.....#
###.#.#.#####.###.#.#.###.#.#.#
#...#.#.....#.#...#.#.#...#S#.#
###############################
