###############################
#.............................#
#.###.#.#####.#######.#.###.###
#...#.#.....#.......#.#...#...#
#######.#.###.#########.#.#####
#.....#S#...#.........#.#.....#
#.#.###.#.#.#.###.#.#.#.#.#.###
#.#...#.#.#.#...#.#.#.#.#.#...#
#.#.#######.###.###.###.#.#.###
#.#.......#...#...#...#.#.#...#
#.###.#.###.###.#####.#.#######
#...#.#...#...#.....#.#.......#
#.#####.#.#####.###.###.###.#.#
#.....#.#.....#...#..E#...#.#.#
###############################
