###############################
#.........#.......#.....#.....#
###.###.#########.#.###.#.###.#
#.#...#..S#...........#.#.#..E#
#.#.###.###.###.#.###.#####.#.#
#.....#.....#.#.#...#.#.#...#.#
###.#####.###.#####.#.#.#####.#
#.#.....#.#.......#.#.#.....#.#
#.#.#.###.#.#####.#.###.###.#.#
#.#.#...#.....#...#.#...#.....#
#.###.#.#.#########.###.#####.#
#.#.#.#.#.#.#.#...#...#...#...#
#.#.#.#.#.#.#.###.#.#####.#####
#.....#.#.....#...............#
###############################
