###############################
#.....#.......#...............#
#.###.#####.#.###.#######.###.#
#...#.......#...#...#...#...#.#
###.###########.#####.#.###.#.#
#...#.........#.......#...#.#.#
#.###.###################.###.#
#.#S#.....#.......#.....#.....#
#.#.#.###.#.#.#####.#.#######.#
#.#.#.#...#.#.....#.#.......#.#
#.#.#.#.###.#####.#.###.#####.#
#.#.#.#...#.#...#.#.#.#...#...#
#.#.#.###.#.#.###.#.#.###.#.###
#.#.#.#...#.#.#...#.#.#E..#...#
#.#.#.#.###.#.#.###.#.#.#####.#
#...#.#.......#.......#.......#
###############################
