###############################
#....E#.........#...#.........#
###.###########.###.#######.###
#.........#.........#.......#.#
#.#.###.###.###.###.#.#.###.#.#
#.#...#...#.#...#.....#.#...#.#
#.#.#.###.#####.#.#####.#####.#
#.#.#.#.#.....#.#.#.#S........#
#####.#.#####.###.#.#####.###.#
#.......#...............#.#...#
###############################
