###############################
#......E......................#
###.#########.#.###.#####.#####
#.#.........#.#...#.....#.....#
#####.#.#######.#.#.#.###.###.#
#...#.#.......#.#.#.#...#...#.#
#.#####.###.#######.#.#########
#.....#...#.......#.#.........#
#.###.###.#.#.#.###.#.###.#####
#...#...#.#.#.#...#.#...#.....#
#.#.###.#.#.#.#######.###.###.#
#.#...#.#.#.#.......#...#...#.#
#.#####.#.#.#####.###.#######.#
#.....#.#.#.....#...#.......#.#
###.#.#.###.###.#.#####.#.###.#
#.#.#.#...#...#.#.....#.#S..#.#
#.#.#######.###.#######.#.#.###
#.#.......#...#.......#.#.#...#
###############################
