###############################
#.#.....#E......#.........#...#
#.###.###.#######.###.###.#.#.#
#.......#.#...#.#.#...#.#...#.#
#####.#.#.#.###.#.###.#.#.#####
#...#.#.#.#...#...#.#...#....S#
###.#.###.###.#.###.###.#.#.###
#...#.#.........#.......#.#.#.#
#.###.#.###.#########.###.#.#.#
#.#.....#.........#.#.#...#...#
#.###.#.#.#.#.#.#.#.###.###.#.#
#.....#.#.#.#.#.#.#.......#.#.#
###############################
