###############################
#.....#.....#.....#.....#.....#
###.#.#.#.#####.#######.#.###.#
#...#.#.#.#...#.......#...#.#.#
###.#.#.#.###.#######.#.#.#.#.#
#...#...#...............#.#.#.#
#######.#########.#########.#.#
#...#.#.#.........#.......#...#
#.#.#.#.#.#.#.#####.#.#####.###
#.#.....#.#.#.....#.#.....#...#
#########.###########.#.###.#.#
#.....#.#...#...#.#.#E#...#.#.#
###.###.###.###.#.#.###.###.###
#.#.....#.#...#...........#...#
#.#.#.#.#.###.#.#.#####.###.###
#.#.#.#.........#.....#.#.#...#
#.###.#.#########.#.###.#.#.#.#
#.....#...#.......#.#.....#.#S#
###############################
