###############################
#.........#...#.......#...#...#
###.#####.#.#.#.#####.#.#.#.#.#
#S..#...#.#.#...#.....#.#...#.#
#######.#.#.#######.#########.#
#.......#.#.......#.#.....#...#
#.#######.#####.#.#.###.#.#.###
#.#.....#....E#.#.#...#.#.#...#
#.#.###.#####.###.###.#.#.###.#
#.....#...........#.....#.....#
###############################
