###############################
#S...........................E#
#######.#.#.###.#.#.#####.###.#
#.....#.#.#...#.#.#.....#...#.#
#####.#.###.#####.###.###.###.#
#...#.#...#.....#...#...#...#.#
###.#.#.#######.###.#.#####.#.#
#.#.#.#.......#...#.#.....#.#.#
###.###.#.###.#.###.###########
#.#...#.#...#.#...#...........#
###.#.#.#####.###.#####.#####.#
#.#.#.#.....#...#.....#.....#.#
#.#.###.###.#########.###.###.#
#.#...#...#.........#...#...#.#
#####.###.#.###.#.###.#####.###
#...#...#.#...#.#...#.....#...#
###.#####.#.###.#.#######.###.#
#.#.....#.#...#.#.......#...#.#
###############################
