###############################
#.............................#
#####.#.###.###.###########.###
#...#.#...#...#..S........#...#
###.###.#.#.#.#.#####.#.#######
#.#...#.#.#.#.#.....#.#.......#
#.#.#.###.#######.#####.###.###
#.#.#...#.......#.....#...#...#
#####.#.#.#.###.#.#######.#####
#...#.#.#.#...#.#.......#.....#
#.#.#####.#.###.###############
#.#.....#.#...#...............#
###.#####.#####.#.#####.#.###.#
#.#.....#.....#.#.....#.#..E#.#
#.#.#.#.###.###.#.#.#.#.#.#.#.#
#.#.#.#...#...#.#.#.#.#.#.#.#.#
#.#.#########.#####.#.#####.###
#.#.........#.....#.#.....#...#
#.#.###.#.#.#.###.###########.#
#.#...#.#.#.#...#...........#.#
###############################
