###############################
#.......#.....................#
#.#######.#################.#.#
#.#.......#.................#.#
#.#.#######.#.#####.#########.#
#.#.......#.#.#...#.#..S#...#.#
#.#######.#.###.#.###.###.###.#
#.....#...#...#.#.....#.......#
#.#####.#####.#.###############
#.......#...#.#...#...........#
#.#######.#.#.###.#.###.#####.#
#.#...#...#.#.#...#...#.#...#.#
#.###.#.###.#.#.#######.#.#.#.#
#.#...#.#.#...#E..#...#.#.#...#
#.#.###.#.#.#####.#.#.#.#.#####
#...#...#...#...#...#...#.#...#
###.#.#######.#.#########.#.#.#
#...#.........#...#.....#.#.#.#
#.###############.#.#.#.#.###.#
#.#.......#.....#...#.#.#.#...#
#.#.#.###.#####.#####.#.#.#.###
#.#.#.#.#...#...#.....#.#.#...#
#.###.#.###.#.#.#.###.###.###.#
#...#.#.....#.#.#.#...#...#...#
###.#.#.#####.#.#.#####.###.#.#
#.....#.......#.#...........#.#
###############################
