###############################
#...#.............#...#.......#
#.#.#.#####.###.#.#.#.#.#.###.#
#.#...#...#...#.#.#.#...#.#...#
#######.#.#####.###.#####.#####
#.....#.#.#...#...#.#...#.#...#
#.###.#.#.#.#.###.#.###.#.#.#.#
#.#.....#...#.....#.#...#...#.#
#.###########.#####.#.#.#####.#
#.#.......#.#.#..E..#.#.#.....#
#.#.#####.#.#.#.#####.###.###.#
#.#.#...#.#...#.#.....#...#.#.#
#.#.#.#.#.###.#.###.###.###.#.#
#.#.#.#.#...#.#...#...#.#.....#
#.#.###.###.#.###.###.#.#######
#.#...#.#...#...#.....#.......#
#.###.#.#.#####.###.#####.###.#
#...#...#.#.....#...#...#...#.#
#.#.###.#.#####.#.###.#.#####.#
#.#.#...#.....#.#.#...#...#...#
#.###.#######.###.#.#####.#.###
#.......#...#.....#.#.....#...#
#.#####.#.#########.#.#####.#.#
#.#S#.....#.......#.#.#...#.#.#
#.#.#######.#####.#.#.#.#.###.#
#.#.......#...#.#...#...#...#.#
#.#######.###.#.###########.#.#
#.......#.....#...............#
###############################
