###############################
#.......#.....#.#.#.....#...#.#
###.###.#.#####.#.#.###.#.#.#.#
#.#...#.#.......#.....#...#...#
#.#.#.#.#.#######.#####.#######
#...#.#.#...#.....#.#.......#.#
###.#####.#.#.#####.#.###.###.#
#.........#...#.#...#...#.....#
#.###.#######.#.###.#.#.#####.#
#.#.........#...#...#.#.#.#...#
#.#.#.#########.#.#.#.###.#.#.#
#.#.#.......#...#.#.#.#.#...#.#
###.#######.###.#.#####.#####.#
#S#.#.#...#...#.#...#...#...#.#
#.###.###.###.#####.###.###.#.#
#.#.#.......#...#E......#...#.#
#.#.#.#######.###.#.###.###.#.#
#.....#.......#.#.#...#...#...#
###.#.###.#####.#####.#####.###
#...#.............#...........#
###############################
