###############################
#.............................#
###.#.#.#.#.#.#.###.#.#.#####.#
#.#.#.#.#.#.#.#...#.#.#.....#.#
#######.#.###.###.###########.#
#.....#.#...#...#...........#.#
#.#.###.#.###.#.#.#.###.###.#.#
#.#...#.#...#.#.#.#...#...#.#.#
#.#.#########.###.#.#.###.#.###
#.#.........#...#.#.#...#.#...#
#.#.#.###.#######.#.#.#.#######
#.#.#...#.......#.#.#.#.......#
#####.#####.#.#.#####.###.###.#
#...#.....#.#.#.....#...#...#.#
###.#.###.#######.#.#.#.###.###
#.#................S#.#...#...#
#.#.#.###.#.#######.#.#.#.###.#
#...#...#.#.......#.#.#.#...#.#
###.#.#####.#####.#.#.#####.#.#
#.#.#.....#.....#.#.#.....#.#.#
#.#.#.#.#.#.###.#.#.###.###.###
#...#.#.#.#...#.#.#...#...#...#
###.#.###.###.#.#.#.#####.#.###
#.#.#...#...#.#.#.#.....#.#...#
#.#.#####.#####.###.#.#######.#
#..E....#.....#...#.#.......#.#
###############################
