###############################
#.#.....#...#.......#.........#
#.#.#####.#.#.#.###.#####.###.#
#.........#...#.#...#.....#...#
#.#.###.#########.###.#.#######
#.#.#...#.......#.....#...#.#S#
#.#####.#.#.###.###########.#.#
#.#...#...#.#...#...#.#.......#
#.#.###.#.#.#######.#.#.#######
#.....#.#.#.#.#...#...........#
###.#########.#.#.#.###########
#.#...#.....#...#.#.....#.....#
#.###.#.#.#.###.###.#####.###.#
#...#...#.#.#.........#.#...#.#
#.#.#.#########.#.###.#.#.#.###
#.#.......#.....#.#.......#.#.#
###.#######.#.#####.#.#######.#
#...#.......#.#.#...#.....#...#
###.#.#.#.###.#.#####.#.#.#.###
#...#.#.#.#...#...#.#.#.#.....#
###.#.#######.###.#.#######.###
#.#E#.....#.#.#.#.....#.......#
#.#.###.#.#.###.###.#####.###.#
#.......#.......#.........#...#
###############################
