###############################
#.....#.#.#.#...#.#...#...#.#.#
#.###.#.#.#.#.###.###.#.###.#.#
#.#.....#.....#.......#.....#.#
#.#.#.#####.###.###.###.#####.#
#.#.#..E......#.#.#...#...#...#
#.#######.#.#.#.#.#####.###.###
#.#.......#.#.............#...#
###.#######.#.#####.#.###.#.###
#.....#.#.#.#.#.....#.#.....#.#
#.#####.#.###.#######.#####.#.#
#...........#.#.#...#.....#.#.#
#############.#.###.#####.#.#.#
#...#...#...#.#.........#.#...#
###.#.#.#.#.#.#####.#####.#####
#.....#...#.#...........#.#...#
#####.#.#.###.#######.#.#####.#
#...#.#.#...#.#.#...#.#.....#.#
###.#.#####.#.#.#.#####.#.#.#.#
#...#...#...........#...#.#...#
###.#.#.#.#.###.###.#.###.#####
#.....#.#.#.#.....#.#...#....S#
###############################
