###############################
#.#.......#.#.#...........#...#
#.#.#.#####.#.#.###.#########.#
#...#...#.........#.#.....#.#.#
#.#.#########.#####.###.###.#.#
#.#.#...#....E#...#.#.......#.#
#.#####.#.#.###.#########.#.#.#
#.......#.#...........#...#.#.#
#######.#.#.#########.###.###.#
#.#.......#...#...#.......#...#
#.#######.#.#.#.###.#####.###.#
#.....#...#.#.#.....#...#.....#
###.#########.#####.#.#####.###
#.........#.....#.#...#...#...#
#.#######.#.###.#.###.###.###.#
#...#.#.#.#...#.....#.....#...#
#.#.#.#.#.#.#.#####.#######.###
#.#.#.#.#...#.....#.....#...#.#
###.#.#.###.#####.#####.###.#.#
#.........#.#.#...#...#...#...#
#########.###.#.#.###.#.###.###
#...#...#...#.#.#.....#.#.....#
#.###.###.#.#.###.#####.#######
#.#...#.#.#.#.....#..S#.#.....#
#.###.#.#.#####.#.#.###.#.#.###
#.............#.#...#.....#...#
###############################
