###############################
#.............................#
#####.#####.#.#############.#.#
#...#.....#.#.............#.#.#
#.###.###.#.#.###.#############
#...#...#.#.#...#.............#
###.#####.###.#####.###.#####.#
#.#.....#...#............S..#.#
###.#.#########.#.#.#.###.###.#
#.#.#.........#.#.#.#...#...#.#
#############.#.###.#####.#.###
#...........#.#...#.....#.#...#
###.###.#.#.#.#.#.###.#.#######
#.#...#.#.#.#.#.#...#.#.......#
#.#.#.#.#.#.#.#.#.#.###.###.###
#.#.#.#.#.#.#.#.#.#...#...#...#
#.#.###.#.###.#.#####.#.#######
#.#...#.#...#.......#.#.......#
#.#######.###.#.#.#.#.#.#######
#.......#...#.#E#.#.#.#.......#
#.#.#.#########.#.###.###.#.###
#.#.#.........#.#...#...#.#...#
###.#.#########.#########.#.#.#
#.#.#.........#.........#.#.#.#
#.#.#######.#####.#.#.###.###.#
#.#.......#.....#.#.#...#...#.#
###############################
