###############################
#.........#.......#...#.......#
#####.###.#.#####.###.#.###.#.#
#.....#.#...#...#...#...#...#.#
#.#####.#####.#.###.#.###.###.#
#...#.........#...#.#.#...#...#
###.#######.#####.#.###.###.###
#.#.#.....#.#.....#.#...#...#.#
#.#.#.###.###.###.#.#.###.###.#
#.#.#.#.#.#...#.#.#...#.#.#...#
#.#.#.#.#.#.###.#.#####.#.#.#.#
#.#S#.#.#.#.#.....#...#...#.#.#
#.###.#.#.#.###.###.#.#.###.#.#
#.....#.#.#...#.#...#...#...#.#
###.###.#.###.#.#.#######.###.#
#...#.#.......#.#.....#...#...#
#.###.#.#####.#######.#.#####.#
#.#.#...#...#.#.......#.....#.#
#.#.#.###.#.###.###########.#.#
#.#.#...#.#.....#....E..#...#.#
#.#.###.#.#######.#.###.#.###.#
#.#.....#.#.....#.#...#...#.#.#
#.#######.###.#.#####.#####.#.#
#.............#.......#.......#
###############################
