###############################
#.#....S#.......#.#...#.....#.#
#.###.#######.###.#.#####.###.#
#...#...#.#.............#.#...#
#.#.#.###.#######.#####.#.###.#
#.#.#.#.....#...#.#.........#.#
###.#.#####.#.#########.#####.#
#.#.#.....#.......#.#...#.#.#.#
#.#.#.#######.###.#.#.#.#.#.#.#
#...#...#...#.#.....#.#.#...#.#
###.###.###.#.#####.#.###.###.#
#.......#.......#.........#.#.#
#.#######.#########.###.#.#.#.#
#.......#.....#.#.....#.#...#.#
#.#######.#.###.#####.#####.#.#
#.........#.#.....#.#.#...#...#
#.#.#####.###.#.###.#.#.#######
#.#.#...#.#...#.#E..#.....#...#
###.#.#####.###.#.#.#####.#.#.#
#.....#...#.#.#...#...#.#...#.#
#.#.#.#.#.###.###.###.#.###.###
#.#.#.#.#...........#.........#
###############################
