###############################
#.............................#
###.###############.#.#.#.#.#.#
#.#...............#.#.#.#.#.#.#
#.#.###########.#######.#####.#
#.#...........#.......#.....#.#
#.#######.#.#######.#.#.###.###
#.......#.#.......#.#.#...#...#
#.###.#.###.###.#######.#.#.#.#
#...#.#...#...#.......#.#.#.#.#
#######.###.#.#.###.#######.#.#
#.....#...#.#.#........E..#.#.#
#.#.###.###.#.#.#.#.#.#.###.#.#
#.#...#...#.#.#.#.#.#.#...#.#.#
###.###.#.#.#.###.#.#.###.###.#
#.#...#.#.#.#.....#.#...#...#.#
#.#####.#####.#.#.###.#.#####.#
#.....#.....#.#.#...#.#.....#.#
###.#######.#.#.#.#####.#.###.#
#.#.......#.#.#.#.....#.#...#.#
#.#####.#.#.###.#.#####.###.###
#.....#.#.#...#.......#...#...#
#.###.#.###.#####.#.###.#.#.###
#...#.#...#......S#...#.#.#...#
###############################
