###############################
#...#.....#.#.......#.#.#.....#
###.###.#.#.#.#######.#.#.###.#
#.....#.#...#...#.......#...#S#
###.#.#####.###.#.###.#####.###
#...#.....#.#.#.....#...#.#...#
#####.#####.#.#.#####.###.#.#.#
#.#..........E....#.#.......#.#
#.#########.#####.#.###.###.#.#
#...#.#.......#...#...#...#.#.#
###.#.###.#######.###.#########
#.#...#.#...#.#...........#...#
#.#.#.#.###.#.#########.#.#.#.#
#...#.....#.....#.......#.#.#.#
#.#######.#############.###.#.#
#.#.#.#.........#.........#.#.#
#.#.#.#.###.#####.###.###.###.#
#...#...#.......#.#.....#.#...#
#####.#######.#######.#####.###
#...#.#...#.#...#.....#.......#
#.#.#.#.#.#.#.#######.#######.#
#.#...#.#.#.#...#.#.....#.....#
#.#######.#.#####.#.#.#######.#
#.#.#.#.#...........#.......#.#
#.#.#.#.#######.###.#.#.###.#.#
#...........#...#...#.#.#...#.#
#.#.#.###.#.#.#.###.#.#.###.#.#
#.#.#.#...#...#...#.#.#.#.....#
###############################
