###############################
#...#............E..#...#.....#
#.#.#.###########.###.###.###.#
#.#...#.#...#.............#...#
#.#.###.#.###.###.#.#####.#####
#S#.#.......#.#...#.#.....#...#
#####.###.#.#######.#####.#.#.#
#.#.....#.#...#.....#.......#.#
#.###.#######.###.###.#.#######
#.....#.......#...#...#.#.....#
#.#.#.###.#.#.#####.#######.#.#
#.#.#...#.#.#.#...#.....#...#.#
#####.###.###.###.###.#.###.###
#...#...#.#.....#.#.#.#.....#.#
###.#.#.#####.###.#.#.###.###.#
#.#...#...#...#.#.....#.#.....#
#.#####.#####.#.#.###.#.#.#.###
#.......#.#...#...#...#...#...#
#####.###.#.#####.###.#####.###
#.......#.#.....#...#.#...#.#.#
#.#.#####.#.#####.###.#.###.#.#
#.#...#.#...........#.#.#.#.#.#
#.#.#.#.###.###.###.#.#.#.#.#.#
#.#.#...#.#...#.#.#.#.#.....#.#
#.###.###.#.#.#.#.#.#.#.#.#.#.#
#.#.....#...#.#.#...#.#.#.#...#
###############################
