###############################
#.......#.........#.........#.#
#######.#.#####.#.#######.#.#.#
#.....#.......#.#...#.....#E..#
#.###.#.#######.###.#.#######.#
#.#...#.#.....#...#.#.#.#.....#
#.###.###.###.###.#.#.#.#.#####
#...#.....#.#.....#...#...#...#
#.#.#######.###########.###.#.#
#.#...#...#.........#...#.#.#.#
#.###.#.#.#.#####.#.#.###.#.#.#
#...#.#.#...#...#.#.#.#.....#.#
#.###.#.#####.#.#.#.#.#######.#
#.#...#.#.....#.#.#.#.........#
#.#.#####.#####.###.#########.#
#.#.#.....#.....#...#.#...#...#
###.#.#####.#####.#.#.#.#.#.###
#...#...#...#.#...#...#.#.#.#.#
#.#####.#.###.#.#.#####.#.#.#.#
#...#...#..S#.#.#.....#.#.#...#
###.#.#######.#.#####.#.#.###.#
#...#.....#...#.#...#.#.#...#.#
#.#######.#.#.#.#.#.#.#.#.###.#
#.......#.#.#...#.#...#.#.....#
#######.#.#.#####.#####.#######
#.....#...#.#...#.....#.#...#.#
#.###.#####.###.#####.#.#.#.#.#
#...#...............#.....#...#
###############################
