###############################
#...........#.#..E............#
#.###.#.#####.#####.#######.#.#
#.#...#...#.....#.....#.#...#.#
#.###.###.#.#.#.#####.#.#####.#
#.#...#...#.#.#.#...#.....#.#.#
#.#####.###.#####.#####.#.#.###
#.#.........#.#.......#.#...#.#
###.#.#.#####.#.#.#.#.###.#.#.#
#.#.#.#.#...#.#.#.#.#.#...#...#
#.#.#######.#.###.###.#.#######
#.#...#.#.#.......#...........#
#.#.#.#.#.#.#######.#.###.###.#
#...#.#.#.....#...#.#.#.#.#S#.#
###.#.#.#.###.#.###.###.###.###
#...#.....#.......#...#.......#
#.###.###.#####.#.#####.###.###
#.#.....#.#.#...#.#.....#.....#
#.###.#####.#.###.#.#####.#####
#...#.......#...#.#.....#...#.#
#.###.#########.###.###.#.###.#
#...#...#.............#.#.....#
###############################
