###############################
#.............................#
###.###.#.###.###.#.#.#.#.#.#.#
#.#...#.#...#...#.#.#.#.#.#.#.#
#.#######.###.#.#.###.#.#.#.#.#
#..E....................#.#.#.#
###.###.#.#.###.#.#####.#####.#
#.#...#.#.#...#.#.....#S....#.#
#.#.###########.###.#####.#.#.#
#.#...........#...#.....#.#.#.#
#.###.###.#.#######.#########.#
#...#...#.#.......#.........#.#
#.#######.#.#######.#.#.###.#.#
#.......#.#.......#.#.#...#.#.#
#############.#####.#####.#.#.#
#...........#.....#.....#.#.#.#
#####.###.#.###.###.#.#.#.#####
#...#...#.#...#...#.#.#.#.....#
#.###.#.#.#####.#########.#.#.#
#...#.#.#.....#.........#.#.#.#
#.#.###.#######.###.#.###.#####
#.#...#.......#...#.#...#.....#
###############################
