###############################
#.................#...#.....#.#
#.#######.#.#####.#.###.###.#.#
#...#...#.#.#.......#.....#.#.#
#.###.#.###.#####.###.#####.#.#
#.#...#.....#...#.#.....#...#.#
#.#.#########.#.###.#####.###.#
#.#...........#.......#...#...#
#.#####################.#####.#
#.......#...#.....#.....#.....#
#######.#.#.#.###.#.#####.###.#
#.#.....#.#.#.#...#..S#.....#.#
#.#.#####.#.#.#.#.#########.#.#
#...#..E..#...#.#.........#.#.#
#.#############.#########.#.#.#
#.#.....#.......#.#.....#...#.#
#.#.#.#.#.#######.#.###.#####.#
#.#.#.#...#.....#...#.#.....#.#
#.###.#####.###.#.###.###.###.#
#.#...#...#.#.#...#.....#.....#
#.#.###.#.#.#.#########.#######
#...#...#.....................#
###############################
