###############################
#.............................#
###.#.#.###.#############.###.#
#.#.#.#...#.............#...#.#
#.###.###.#######.#.#.#########
#...#...#.......#.#.#.........#
###.#####.###.###.#.#.###.#.###
#.#.....#...#...#.#.#...#.#...#
#.###########.#.#.#.###.###.###
#..E..................#...#...#
#.#.#.#####.#.#.###.###.#####.#
#.#.#.....#.#.#....S..#.....#.#
###.#.#.#####.###.#.###.#.#.###
#.#.#.#.....#...#.#...#.#.#...#
#.#.#.#####.#########.#####.#.#
#.#.#.....#.........#.....#.#.#
#.#######.#######.###.###.#####
#.......#.......#...#...#.....#
#####.###.###.#.###############
#...#...#...#.#...............#
###############################
