###############################
#.#.............#.......#.....#
#.#.#.#######.###.###.#.#.###.#
#...#...#...#.#...#...#.#...#.#
#.#####.#.#.###.###.###.#.#.###
#.#...#.#.#.#...#.#...#.#.#...#
###.#.#.#.#.#.###.###.#.#####.#
#...#.#.#.#...#.....#.#.....#.#
#.###.#.#.#####.#.###.#####.#.#
#...#E..#...#.#.#.#...#...#...#
#.#.#######.#.#.#.#.###.#.###.#
#.#.........#...#.#.....#.#...#
#.###############.#######.###.#
#...#.....#.........#...#...#.#
###.###.#.#.#.#######.#.#.#.#.#
#.#...#.#...#.#S......#.#.#.#.#
#.###.#######.#########.###.#.#
#...#.......#.....#.#...#...#.#
#.#.#######.###.#.#.#.###.###.#
#.#.............#...#.....#...#
###############################
