###############################
#...#...#...#...#.#.........#.#
#.###.###.#.#.###.#.#.#.###.#.#
#.......#.#.....#...#.#.#...#.#
#.###.###.###.#####.#########.#
#.#.......#.....#.#...........#
###.#####.#######.#.###.###.###
#.#.#...#.........#.#.#...#...#
#.#.#.#.#.#######.#.#.#.#.###.#
#.#.#.#.......#.#.#...#.#...#.#
#.#.#.#######.#.#.###.#.#.###.#
#...#.....#...#.......#.#.#...#
###.#######.###.#####.#####.#.#
#E....#.....#.#.#...#.#.....#.#
#####.###.#.#.###.#.#.#####.###
#.......#.#.....#.#...#...#...#
#.#.#####.###.#.###.#####.#####
#.#.#.#.#...#.#...#.#.......#S#
#.###.#.###.#######.###.#.#.#.#
#...#...#...#...#.#.#...#.#.#.#
#######.#.#.#.###.###.#.#####.#
#.......#.#...........#.#.....#
#.#######.#####.#########.#####
#.....#.....#.......#.......#.#
#.#.#.#####.#######.###.#####.#
#.#.#.....#.#...#.#...#.......#
###.###.###.###.#.#.#.#.#####.#
#.....#.....#.......#...#.....#
###############################
