###############################
#.........................#...#
#####.###.###############.###.#
#...#...#.#...#.....#.........#
#.#.###.#.#.#.#.###.###########
#.#...#.#E#.#.#.#.#...#.......#
#.###.###.#.#.#.#.###.#.#####.#
#.#.#.#...#.#.#.#...#.#.#...#.#
#.#.#.#.###.#.#.###.#.#.#.#.#.#
#.#.#...#...#.#.....#.#.#.#.#.#
#.#.#.###.###.###.###.#.#.#.#.#
#.#...#...#.#.....#...#...#.#.#
#.#####.###.#######.#####.###.#
#.#.....#...#.....#.......#S..#
#.#.#####.#.#.###.#############
#.#.#.....#.#.#.#.#...#.......#
#.#.#.#####.#.#.#.#.#.###.#.###
#.#...#.#...#.#.#.#.#...#.#...#
#.#####.#.###.#.#.#.###.#####.#
#.............#.....#.........#
###############################
