###############################
#......................E......#
#####.###.#.#######.###.###.###
#...#...#.#.......#...#...#...#
#.###.#.#.#.###.#.###.###.###.#
#...#.#.#.#...#.#...#...#...#.#
#######.###########.#.###.#.###
#.....#...........#.#...#.#...#
#.###.#.###.###.#######.#.#.###
#...#.#...#..S#.......#.#.#...#
#.#.###.###.###.#.###.#.#.#.#.#
#.#...#...#...#.#...#.#.#.#.#.#
###.#.#.#.#.#####.#.#.#.###.###
#.#.#.#.#.#.....#.#.#.#...#...#
###.#####.#.###.#.#.###########
#.#.....#.#...#.#.#...........#
###.#.###############.#.#######
#.#.#...............#.#.......#
#####.#.#.#.#.#.#.#.#.###.#.###
#...#.#.#.#.#.#.#.#.#...#.#...#
#.#####.#####.#.#########.###.#
#.....#.....#.#.........#...#.#
#.#.#####.#####.###.#.###.#.#.#
#.#.....#.....#...#.#...#.#.#.#
#.###.#.###.#.###.#.#####.#.#.#
#...#.#...#.#...#.#.....#.#.#.#
###########.#.#########.#.#.###
#.........#.#.........#.#.#...#
###############################
