###############################
#.............................#
#########.#.#####.#.#.#####.###
#.......#.#.....#.#.#.....#...#
#.#####.###.###.#.#.###.#####.#
#.....#...#...#.#.#...#.....#.#
#.#####.#######.#.#.#####.#.###
#.....#.......#.#.#.....#.#...#
#.###.###.###.#.###.#.###.#.#.#
#...#...#...#.#...#.#...#.#.#.#
###.###.#.###.#.###.#####.#####
#.#...#.#...#.#...#.....#.....#
#.###.###.#######.#.#######.###
#...#...#..S..................#
###.###.#####.###.#####.###.#.#
#.#...#.....#...#.....#...#.#.#
#.#.#.#.###.#.#.#####.#####.#.#
#.#.#.#...#.#.#.....#.....#..E#
#######.#####.#####.###.###.#.#
#.....#.....#.....#...#...#.#.#
###############################
