###############################
#.............................#
#.#.#####.###.###.###.#.###.###
#.#.....#...#...#...#.#...#...#
###.#.###.#.#.#########.#######
#.#.#...#.#.#.........#.......#
#.###.#############.###.###.###
#...#S............#...#...#...#
#.#.#########.#.###.###.#.#.#.#
#.#.........#.#...#...#.#.#.#E#
#.#.#####.#.###.#.#.#####.###.#
#.#.....#.#...#.#.#.....#...#.#
###.###########.###########.###
#.#...........#...........#...#
#############.###.#.#.#####.#.#
#...........#...#.#.#.....#.#.#
#############.###.###.#####.###
#...........#...#...#.....#...#
#.###.###.###.#.#.#.###.###.###
#...#...#...#.#.#.#...#...#...#
#.#.#.#########.#.###.#.#######
#.#.#.........#.#...#.#.......#
###.#########.#.#####.###.#####
#.#.........#.#.....#...#.....#
###############################
