###############################
#...#.#...#.#.....#.....#.#...#
#.###.#.###.#####.#.###.#.#.###
#...........#.#.#...#.........#
#.#######.###.#.#########.#####
#.....#.#.#.......#.#.........#
#.###.#.#####.#.###.#.#.###.#.#
#.#.......#...#.#.#.#.#...#.#.#
#.###.###.#.#####.#.###.#.###.#
#...#...#.....#.#...#...#...#.#
#.###.#########.#.#.#####.#####
#.#.....#E..#.....#.#.#.......#
###.###.#.#.#####.#.#.###.#####
#.....#...#...#...#...#.#.....#
###.###.#####.#.###.###.###.###
#.#.#...#.#.....#.....#.#...#.#
#.#####.#.#.#########.#.#.###.#
#...#.....#.#...#...#.#...#.#.#
#.###.#####.#.#####.#.###.#.#.#
#.#...#.....#.#.......#.#.....#
#.#.#######.#.###.#####.#.#.###
#...#.........#...#.....#.#...#
#####.###.#.###.#####.#.#####.#
#S......#.#.#.........#.......#
###############################
