###############################
#.............................#
#######.###.#.#.#####.#.#.#.#.#
#.....#...#.#.#.....#.#.#.#.#.#
###.#.#.#.#.#.#########.#.#.###
#.#.#.#.#.#.#.........#.#.#...#
#.#.#####.###.###.###.#.###.###
#.#....E..............#...#...#
#.#.#.#.###.#.#.#####.###.#.#.#
#.#.#.#...#.#.#.........#.#.#.#
#####.#.###.###.###.#.#####.#.#
#...#.#...#...#...#.......#.#.#
#########.#.###.###.#.###.#####
#.......#.#...#...#.#...#.....#
#######.###.#.#.#####.#.#.#.###
#.....#...#.#.#.......#.#.#...#
#.#.#.###.#.#.#######.#.###.#.#
#.#.#...#.#.#.......#.#...#.#.#
#.#########.#.#.#####.###.#####
#.........#.#.#.........#.....#
###.#.#.#####.#.#####.#.###.###
#.#.#.#.....#.#.....#S#...#...#
###############################
