###############################
#.....#.....#.......#.#.......#
###.#.#####.#.###.###.#.#.#####
#...#...#.#.#.#.......#.#...#.#
###.###.#.#.###.###.#####.#.#.#
#.....#...#.......#.......#...#
#####.###.###########.#.###.###
#...#...#.......#...#.#.#.#.#.#
###.###.#.#######.#.###.#.###.#
#.#...#.#E#.....#.#...........#
#.###.#.#####.###.#.#.#.#.###.#
#.#.........#.....#.#.#.#...#.#
#.###.#.#.#####.#########.###.#
#...#.#.#.#.#.....#...#...#.#.#
#.#####.#.#.###.#####.#####.###
#.......#.......#...#.#...#...#
#######.#####.###.###.#.#.###.#
#.......#.#.............#.#.#.#
#.###.#.#.#####.#########.#.#.#
#...#.#.......#.#S............#
###############################
