###############################
#.#.............#...#.........#
#.#.#.###########.#.#.###.###.#
#...#.#.........#.#.....#.#...#
#.###.#.#######.#.#######.###.#
#.#.#...#.....#.......#S#...#.#
#.#.#########.#######.#.#.#.###
#.#.....#.......#...#.#.#.#...#
#.#.###.#.###.###.#.###.#####.#
#.#.#.....#.#.#...#.#...#.....#
#.#.#######.#.#.###.#.###.#####
#.#...#...#...#.#.#...#.......#
#.###.#.###.###.#.###########.#
#.....#...#...#.#.........#...#
#######.#.###.#.#.#.#####.#.#.#
#...#.#.#.....#.#.#.#...#...#.#
#.#.#.#.#######.#.###.#.#####.#
#.#...#...#.#...#.....#.....#.#
#.###.###.#.#.#########.###.#.#
#.#...#E..#.#.#...#...#...#.#.#
#.#####.###.#.#.#.#.#.###.#.#.#
#.#.....#...#.#.#...#.#...#.#.#
#.#.#####.###.#.#####.#.###.#.#
#.#...#...#...#.#.#...#...#.#.#
#.###.#.#.#.###.#.#.#######.#.#
#.......#.#.....#...........#.#
###############################
