###############################
#...#...............#.....#...#
#.#.#.#######.#####.###.#.###.#
#.#.#.#...#...#.......#.#.....#
###.#.#.###.#.#######.#.#####.#
#...#.#.#...#.#...#.....#.#...#
#.#.#.#.#.###.#.#.#######.#.###
#.#.#...#.#.#.#.#.....#.#...#.#
#.###.###.#.#.#.#####.#.#.###.#
#.#...#...#.#.#S#.#...#...#...#
#.#.###.###.#.###.#.###.###.#.#
#...#...#.....#...#.#.#.#.#.#.#
#####.#.#####.#.#.#.#.#.#.#.#.#
#.....#.#...#.#.#.#.#...#...#.#
#.###.###.#.#.#.#.#.###.#####.#
#.#...#...#.#.#.#.#...#.......#
#.#####.###.#.###.###.#######.#
#..E#...#...#...#...#.#...#...#
#.#.#.###.#####.###.#.#.###.###
#.#...#.#.#.........#.#...#.#.#
#.#####.#.#########.#.#.#.#.#.#
#.#...#.#.#...#.....#.#.#.#.#.#
#.#.#.#.#.#.#.#######.#.#.#.#.#
#...#...#...#.........#.#.....#
###############################
