###############################
#...#.....#...............#...#
#.#.#.###.#.#######.#####.###.#
#.#.....#.#.#.....#...#.#.#...#
#.#######.#.###.#.###.#.#.#.###
#...#.#...#.....#...#.#...#...#
###.#.#.###.#########.#.###.#.#
#...#.#.#...#...#.....#...#.#.#
#.###.#.#.###.#.#.#######.###.#
#.#...#...#...#...#.....#...#.#
#.#.#.#####.###.#####.#####.#.#
#...#.#.....#...#...#.......#.#
#######.#########.#.#####.###.#
#.......#.......#.#.....#.....#
#.#######.#####.#.#####.#######
#.........#...#.......#.......#
#.#########.#####.#####.#####.#
#...#.....#.#..S#.#...#.....#.#
###.#.###.#.#.#####.#.###.###.#
#.#.#.#.....#.....#.#...#.#...#
#.#.#.###########.#.###.###.#.#
#.#.#.........#...#.#.#.#...#.#
#.#.#########.#.###.#.#.#.#####
#.#...#...#...#.#...#...#E....#
#.###.#.#.#.#.#.###.#.#######.#
#.......#...#.#.....#.........#
###############################
