###############################
#S........#...#.#....E........#
###.###.###.###.#.#########.#.#
#.#.#.........#.#...#.#.#...#.#
#.###.#########.###.#.#.###.###
#.....#.#...#.#.........#...#.#
#.###.#.###.#.###.###.#.###.#.#
#...#.....#.#.#.#.#.#.#...#.#.#
###.###.###.#.#.###.###.#.###.#
#.#...#.........#.....#.#.#...#
#.#.###.#.###.###.#######.###.#
#.....#.#...#.........#.#.#...#
#.#########.#####.###.#.#.#.###
#.#.#.....#.....#.#...........#
#.#.###.#####.#.#######.#.#.###
#.#.....#...#.#.....#.#.#.#.#.#
#.###.###.#.#.#####.#.#####.#.#
#...#.....#.....#.#.#.....#...#
#.#.#######.#.###.#.#.#.###.###
#.#...#.....#...#.....#...#...#
###############################
