###############################
#.........#.......#...........#
#.###.###.#.#####.#.###.#####.#
#...#.#.#.#...#...#.#...#.#...#
#.###.#.#.###.#.#####.###.#.###
#.#...#...#...#...#...#.....#.#
###.#####.#.#####.#.###.#####.#
#...#...#...#.....#.#...#.....#
#.###.#.#####.#####.#.###.#.#.#
#...#.#.#.#...#.....#...#.#.#.#
#.#.#.#.#.#.#######.###.###.#.#
#.#...#.#...#.....#...#...#.#.#
#######.#.#####.#.#.#.###.#.#.#
#...#...#...#...#.#.#...#...#.#
#.#.#.#####.#.###.#####.#####.#
#.#...#.......#.#.....#.#....E#
#.#############.#####.#.#.#####
#.....#S..#.#.......#...#.#...#
#.###.###.#.#.#.#########.#.#.#
#...#.....#...#.............#.#
###############################
