###############################
#.......#...#.....#...........#
#.#.###.###.#.###.#########.###
#.#...#.....#...#.........#...#
#.###.#.#######.#########.###.#
#...#.#.#...#S#.#.#.......#...#
#####.###.#.#.#.#.#.#######.###
#...#.....#.#...#.#.#.....#...#
#.#.#######.#####.#.#.###.#.#.#
#.#.........#.....#.#...#.#.#.#
#.#########.#.#####.#.#.#.###.#
#...#.........#.....#.#.#.....#
#.#.#####.#####.#####.#.#####.#
#.#.....#.#...#.#.....#.#.....#
#.#####.###.#.#.#.#####.#####.#
#.#...#.....#...#.....#.....#.#
#.#.#.###########.#########.#.#
#.#.#.....#.......#.......#.#.#
#.#.###.#.###.#####.#####.#.###
#.#.#...#...#.#...#.#...#.#...#
#.###.#####.#.#.###.#.###.###.#
#.#...#...#.#...#...#...#..E#.#
#.#.###.###.#####.###.#.###.#.#
#...#.............#...#.......#
###############################
