###############################
#.......#.#...#...#.....#.#...#
#######.#.###.###.#####.#.#.###
#...#.#...........#.#...#.#...#
###.#.#####.###.###.#.###.###.#
#...#.#.#.....#...........#.#.#
#.#.#.#.###########.#####.#.#.#
#.#...#.#.#.....#...#.#.#.#...#
#.#.#.#.#.#.###.#.#.#.#.#.###.#
#S#.#.#...#.#.#.#.#.....#.#...#
#####.#.###.#.###.#######.#.#.#
#...#...................#.#.#.#
###.#.#########.#########.#.###
#...#.#.......#.......#...#...#
#.#.###.#####.#####.###.###.###
#.#.....#.#.....#...#.#.#.....#
###.#####.#.#.#.###.#.###.###.#
#.....#.....#.#.#.#.#.....#...#
#.###.#####.###.#.#.###.#.#.###
#.#...#.#...#.......#.#E#.#...#
#.###.#.#####.###.###.#######.#
#.#.#...#.......#.#.#.......#.#
###.###.###.#####.#.###.#.###.#
#.......#...#...........#.....#
###############################
