###############################
#.......#S........#...#...#...#
#.#####.###.#####.#.#.###.#.###
#.....#.......#.....#....E#.#.#
#.#.###.#.#####.#####.###.#.#.#
#.#.#.#.#...#...#.....#.#.....#
#.###.#.#.#####.#######.#.#.#.#
#.#...#.#...#.......#.#.#.#.#.#
###.###.#####.#####.#.#.###.###
#...........#.#.#.#.#...#.....#
###.#######.#.#.#.#.#.###.###.#
#.........#.#...#.#.#.#...#...#
###.#######.#####.#.#.###.#.#.#
#.......#.....#.....#.#...#.#.#
#######.###.#.#######.###.#.###
#.....#.#...#.#.....#.....#.#.#
###.###.#.#.#.###.#####.#.#.#.#
#...#.#.#.#.#.#.#...#...#.#...#
#.#.#.#######.#.#.###.###.###.#
#.#.#...#.#...#.....#.#.#.#.#.#
###.#.###.###.#####.#.#.#.#.#.#
#.....#.#.#.....#.......#...#.#
#####.#.#.#####.###.###.#.#.###
#...#...........#.#.#...#.#...#
#.#.#.#.#.#.#####.#.#####.#####
#.#...#.#.#...#.....#.........#
###############################
