###############################
#...........#.#.......#.......#
#.#######.#.#.#.###.###.#####.#
#.#.....#.#...#.#.#.......#...#
#.###.#.#.#####.#.#########.###
#.....#.#...#...#...#S#...#...#
###########.#.###.###.#.#.###.#
#.......#...#...#...#.#.#.....#
#.#####.#.#.###.###.#.#.#######
#.#...#.#.#...#.#...#...#.....#
#.#.#.#.#.#####.#.#.#######.#.#
#...#.#...#.....#.#.......#.#.#
#####.###.#.#####.#######.#.#.#
#...#.#.#.#.#.....#.....#.#.#.#
#.#.#.#.#.#.#####.#.#.###.#.#.#
#.#...#...#...#...#.#.#...#.#.#
#.#####.#####.#.###.#.#.###.#.#
#.#...#...#...#...#.#.#...#.#.#
#.###.###.#.#####.#.#.###.#.#.#
#...#.#...#.......#.#.#...#.#.#
#.#.#.#.###########.#.#.###.#.#
#.#.#.#.........#...#.#.#...#.#
###.#.#####.#####.###.#.#.###.#
#...#...#...#.....#.#...#...#.#
#.###.#.#.###.#####.#########.#
#.#...#...#...#....E..#.....#.#
#.#########.#######.#.###.#.#.#
#...................#.....#...#
###############################
