###############################
#.............................#
#########.#####.#.#.#.#####.###
#.......#.....#.#.#.#.....#...#
#####.#####.#.#.#.#########.###
#...#.....#.#.#.#.........#...#
#.#.#######.#######.#.#.#.#.###
#.#.......#.......#.#S#.#.#...#
#######.#.#.###.#####.#.#######
#.....#.#.#...#.......#.......#
#####.###############.#.#.###.#
#...#.................#.#...#.#
#.#################.#.###.#####
#.................#.#...#.....#
#.#.#.#.#.#.#.#####.#.#######.#
#.#.#.#.#.#.#.....#.#.......#.#
###.#.#.#####.#.#.#.#.###.#.###
#.#.#.#.....#.#.#.#.....#.#...#
###.###.###.#.#####.#.###.###.#
#.#...#...#.#.....#.....#...#.#
#.#.#.#.###.#####.#.#.#.###.###
#.#.#.#...#.....#.#.#.#...#...#
#.#.#.#######.###.#.#.###.#####
#.#.#.......#...#.#..E..#.....#
#####.#.#####.#####.#.#.#.#.###
#...#.#.....#.....#.#.#.#.#...#
###############################
