###############################
#.............................#
#.#.#.###.#.###.###.#.#######.#
#.#.#...#.#...#....S#.......#.#
#.#.#.#######.#.###.#.#.#.#####
#.#.#.......#.....#.#.#.#.....#
###.#.#.###.###.#.#.#.#.#.#####
#.#.#.#...#.....#.#.#.#.#.....#
#########.#.#.#.###.###.#.#.#.#
#.......#.#.#.#...#...#.#.#.#.#
#.#.#.###.#.###.###############
#.#.#...#.#...#...............#
###############.###.###########
#.............#...#...........#
#.###.#######.#.#.#######.###.#
#...#.......#.#.#.......#...#.#
#.#.#####.#.#.#.#####.#######.#
#.#.....#.#.#.#.....#.......#.#
#####.#.#####.#.#.#.#.#.#.#.###
#...#.#.....#..E#.#.#.#.#.#...#
#######.#.#.###.#########.###.#
#.....#.#.#...#.........#...#.#
#.###########.#.#####.#.#######
#...........#.#.....#.#.......#
###############################
