###############################
#...#...#.......#.#.....#.....#
#.#.###.#.#.###.#.#.#.#.#.#####
#.#.....#.#.#...#...#.#.......#
#.#####.#####.#.#.#####.#####.#
#.....#.#...#.#...#.......#.#.#
#.#.#####.#.#######.#.###.#.#.#
#.#.......#....E....#.#.#...#.#
#.#####.#######.#.#####.#######
#.....#...#.#...#...#...#.....#
#.###.#####.#####.###.#.###.#.#
#.#.#.....#.........#.#...#.#.#
###.#####.###.#####.#.#.#.#.#.#
#...#.......#.#.#.#.#.#.#.#.#.#
###.#.#.#.#####.#.#.#.#.###.###
#...#.#.#.....#.#.....#...#.#.#
#.#.#.#.#.#####.###.#####.#.#.#
#.#...#.#...#.....#...#...#...#
#.#########.#.#.#######.#####.#
#.....#S..#.#.#...#...#.#.#...#
###.#.###.#######.###.#.#.#.###
#.#.#.#...#.........#...#.#...#
#.###.#.#.#######.#.###.#.###.#
#.....#.#...#...#.#.#.........#
###.#.#.###.###.###.#####.###.#
#...#.#...#...#.#...#.....#.#.#
#.#.#.###.#####.#.#.#.#.###.#.#
#.#.#.#...........#...#.#.....#
###############################
