###############################
#.............................#
###.###############.#######.#.#
#.#...............#.......#.#.#
#.#.#####.###.###.#.###.#.###.#
#.#............E#.#...#.#...#.#
#.#.#####.###################.#
#.......#...................#.#
###.#####.#######.#.#####.#.#.#
#.......#.......#.#.....#.#.#.#
#.#.#.###.###.#.#.#.#########.#
#...#...#...#.#.#.#.........#.#
###.#.#########.###.#.#####.#.#
#...#.........#...#.#.....#.#.#
#.#.#.#.#.###.#.#######.###.###
#...#.#.#...#.#.......#...#...#
#.#.#.#.#.#.###.#############.#
#..S#.#.#.#...#.............#.#
###.###.#.###.#.#.#####.#######
#.#...#.#...#.#.#.....#.......#
#.###.#####.###.#.###.#.#.#.#.#
#...#.....#...#.#...#.#.#.#.#.#
###############################
