###############################
#.#.#...#...#.........#.......#
#.#.###.###.#.###.###.#.#####.#
#.......#...#.#.#...#...#.....#
#####.###.###.#.#########.#.#.#
#.#.#.#...#...#.........#.#.#.#
#.#.#.#.#.###.#.###############
#.#.....#.#.............#.....#
#.#.#####.###.#.###.#####.#####
#.......#...#.#.#.#.......#...#
#.###.#####.#.#.#.#####.###.###
#...#.#...#.#.#.#.#.......#...#
#.#####.###.#####.#.#.#####.###
#.#...#.....#.......#...#.#...#
###.###.#####.#.#######.#.#.#.#
#.....#.....#.#.#E..#.......#.#
#.#####.###.###.#.#.#.###.#####
#.....#.#.#.#...#.#.#...#...#.#
#.#.#.###.#.#####.#########.#.#
#.#.#.....#.#...#.#...#.......#
#.#.#####.#.#.###.#.#.#.#######
#.#.#...#.#.....#...#.#.....#.#
###.#.###.#####.###.#######.#.#
#.....#.....#.#...#.#.........#
#######.###.#.#.#.#.#.#.#.###.#
#...#.....#...#.#.....#.#.#.#.#
###.#.#######.#.#####.#####.#.#
#.....#.........#...#.#.....#.#
#########.#.#.###.#####.#####.#
#S........#.#.............#...#
###############################
