###############################
#.......#...#.......#.........#
#.#####.###.#.#####.#########.#
#...#.#.....#.#...#....S#.....#
###.#.#.#####.#.#########.###.#
#...#...#.....#.............#.#
#.#######.#################.#.#
#.#.....#.............#.....#.#
#.#.###.#############.#.#####.#
#.#.#.........#.....#.#.....#.#
#.#.#.#######.#.###.#.#####.###
#...#...#.......#...#.#...#...#
#.#####.#.#######.###.#.#.###.#
#...#...#.#...#.....#...#.#...#
###.#.#####.#.###########.#.###
#...#.....#.#.........#...#...#
#.#######.#.#######.#.#.#####.#
#...#...#...#...#...#.#...#...#
###.###.#####.#.#.###.###.#.#.#
#.#...#.......#.#...#...#...#.#
#.###.#.###.#######.###.#####.#
#.....#.#.#.......#...#.....#.#
#.#####.#.#####.#.###.#.#####.#
#.....#...#...#.#.#...#E#...#.#
#####.#####.#.#.###.#####.#.#.#
#...#.....#.#.#.#...#.....#...#
###.#####.#.#.#.#.###.#########
#.......#.#.#.#.#...#...#.....#
#.#######.#.#.#.###.###.###.#.#
#...........#.....#.........#.#
###############################
