###############################
#.............................#
###.###.#.#.###.#.#.#.#.#.###.#
#.#...#.#.#...#.#.#.#.#.#...#.#
#####.#.#.#.#.#.###.#.#.#.#.###
#...#.#.#.#.#.#...#.#.#.#.#...#
#.#.###.#.#.#.#.###.#.#.###.#.#
#.#...#.#.#.#.#...#.#.#...#.#.#
###.#.#.#########.###.#.#.###.#
#.#.#.#.........#...#.#.#...#.#
#.#.###########.#.#########.#.#
#.#......................S#.#.#
#.#####.#.#.#.###.###.#.#.#####
#.....#.#.#.#...#...#.#.#.....#
#.###.#####.#####.###.#.#####.#
#...#.....#.....#...#.#.....#.#
#####.#.#.#.###.#.#.###.#.#.#.#
#...#.#.#.#...#.#.#...#.#.#.#.#
#########.#.###.###.#####.#.###
#.......#.#...#...#.....#.#...#
#.#.#######.#.#.#.#######.#####
#.#.........#.#.#.......#.....#
###.#######.###.#.###.###.#.#.#
#.#.......#...#.#...#...#.#.#.#
#######.###.###.#.#####.#######
#.....#.......#.#.....#.......#
#.#.###.#.#.#.#####.###########
#.#...#.#...#.....#...........#
###.#.#####.#####.#.#######.###
#.#.#.....#E....#.#.......#...#
###############################
