###############################
#.....#...#.......#...#......S#
#.###.###.#.#######.#.#.#######
#.#.........#.......#.........#
#.#.###########.#.#.#.#.#####.#
#.#.....#...#...#.#.#.#.....#.#
#.#.#.#.#.#.#.#######.#######.#
#.#.#.#...#...#.........#.....#
#.#####.#####.#####.#.#####.###
#.#.#...#.....#...#.#.....#...#
###.#.#.###.###.#####.#######.#
#.....#...#.#.#...#.....#...#.#
#.#####.#.###.###.###.#####.###
#.#...#.#.#...#...........#...#
#####.###.#.###.#.#####.#.###.#
#.....#...#.#.#.#...#.#.#.#...#
#.#####.###.#.###.###.#.###.#.#
#.....#.....#.....#.....#...#.#
#.###.###.###.#.#.#.#####.#.###
#.#...#.#.#...#.#.#.......#.#.#
#####.#.#####.###.###.###.###.#
#...#.....#...#.#...#.#.......#
###.#####.#.###.#####.###.#####
#...#.#.....#.....#...#.#.#...#
#.#.#.#.#####.#.#####.#.#####.#
#.#.......#...#...............#
#.#####.###.#####.#########.#.#
#.....#...#...#...#.......#.#.#
#.#.#####.#####.#.#.#.#####.#.#
#.#E#.........#.#...#.#.....#.#
###############################
