###############################
#.........#.....#.....#.......#
#.#########.#.###.###.#####.#.#
#.....#.....#.....#.#...#...#.#
#.###.#.###########.###.#.#####
#.#.#.#.#.............#.#.#...#
#.#.#.#.#.###########.#.#.#.#.#
#...#.#.#...#.......#.#.#...#.#
#.###.#.###.#.#####.#.#.#####.#
#.#...#...#.#.....#...#.....#.#
#.#.#.###.#.###.#####.#####.#.#
#.#.#.#.....#...#S..#...#...#.#
#.#.#.#.###########.#####.###.#
#.#.#.#...#.........#.....#...#
#.#.#####.#.#########.#####.###
#.#.....#.#.....#.....#.#.....#
#.#####.#.#####.###.###.#.###.#
#.....#.#.....#.#...#.......#.#
#####.#.#####.#.#.###.#######.#
#...#.#.......#...#.#.....#...#
#.###.#############.#####.#.#.#
#.....#...#...........#...#.#.#
#.#####.#.#####.#####.#.###.###
#.#.....#.....#.....#.#...#...#
#.###.#.#####.#####.#####.###.#
#...#.#.#.#...#...#.#.......#.#
###.###.#.#.###.#.#.#.#######.#
#E#.....#.#...#.#.#.....#...#.#
#.#######.###.#.#.#######.#.#.#
#...............#.........#...#
###############################
