###############################
#.............................#
#.#.#.#.#.#.#.#.#.#.#.#.#####.#
#.#.#.#.#.#.#.#E#.#.#.#.....#.#
#####.#.#.###.#######.#.#####.#
#...#.#.#...#.......#.#.....#.#
#.#.###.#####.#.###.#.#.#####.#
#.#...#.....#.#...#.#.#.....#.#
#.#.#.#.#########.#.###.#.###.#
#.#.#.#.........#.#...#.#...#.#
###########.#.#######.#####.#.#
#.........#.#.......#.....#.#.#
#.#.#####.###.#.#.#######.#.###
#.#.....#...#.#.#.......#.#...#
#######.#.###.#.#.#########.#.#
#.....#.#...#.#.#.........#.#.#
###.#.#.###.#.#####.#####.#.###
#.#.#.#...#.#.....#.....#.#...#
###.###.#####.#.#######.#.#.###
#.#...#.....#.#.......#.#.#...#
###.#.#.#.###.#.#######.###.#.#
#.#.#.#.#...#.#.......#...#.#.#
###.#####.#######.###.#####.#.#
#.#.....#.......#...#.....#.#.#
###.#######.#.#.#.#######.###.#
#.#.......#.#.#.#..S....#...#.#
#####.#.###.#.#.###.###.###.#.#
#...#.#...#.#.#...#...#...#.#.#
#######.#####.###.#.#.#.#####.#
#.....#.....#...#.#.#.#.....#.#
###############################
