###############################
#.............................#
###.#.#.###.#.#####.#.###.#####
#.#.#.#...#.#.....#.#...#.....#
###.#.#.###.#.###.#########.###
#.#.#.#...#.#...#.........#...#
#.#.###.#####.#.#####.#.#.#.###
#.#...#.....#.#.....#S#.#.#...#
#.#.#.#.#######.#.#####.###.#.#
#.#.#.#.......#.#.....#...#.#.#
#.#.#.#.#.#.#.#.#.#.#####.#.#.#
#.#.#.#.#.#.#.#.#.#.....#.#.#.#
###.#####.#.###.#############.#
#.#.....#.#...#.............#.#
###.#.#######.#.#.#.###.#.#.#.#
#.#.#.......#.#.#.#...#.#.#.#.#
#.###.###.#.#.#.#.###.#########
#...#...#.#.#.#.#...#.........#
#########.#.###.#.#.###.###.###
#.......#.#...#.#.#...#...#...#
#.###.#######.#.#.###.#########
#...#.......#.#.#...#.........#
#######.#######.#.#####.###.###
#.....#.......#.#.....#..E#...#
#####.#.###.###.#.#.###.###.###
#...#.#...#...#.#.#...#...#...#
#.###.#.#.#.###.#.#.###.#.#.#.#
#...#.#.#.#...#.#.#...#.#.#.#.#
###.#.#.#.###.#.#.#####.#.#.#.#
#.#.#.#.#...#.#.#.....#.#.#.#.#
###############################
