###############################
#...............#.....#.....#.#
###.#.#.#.###.#####.###.#####.#
#...#.#.#...#...#.#...#...#...#
###.#.#.#######.#.#.#.###.###.#
#.#.#.#.#.#.....#...#.#...#...#
#.#####.#.###.###.#.#.###.###.#
#...#.......#.#.#.#.#...#...#.#
###.#######.###.#.#.#######.#.#
#.....#...#.......#.....#.....#
#####.###.###.###.#####.#.#####
#...#.......#.#...#.........#.#
###.###.#############.#.#.###.#
#.#.....#...#..E....#.#.#...#.#
#.###.#.###.#.###.#.#.#####.#.#
#.#...#...#.....#.#...#...#...#
#.#.#####.#.#####.#.###.#####.#
#.....#...#.#.#...#...#.....#.#
#####.#.#####.###.#.#####.###.#
#...#.#...#...#...#.....#...#.#
#.###.#######.#.#####.#####.#.#
#.................#.#.#.#.#...#
#################.#.###.#.#.###
#...#.#.......#...#...........#
###.#.###.###.###.#.###.#.#####
#.#.#.......#...#.#.#...#...#.#
#.#.#.#####.#########.###.###.#
#.#.#...#.....#.#.......#...#.#
#.#.#.#######.#.#.#####.###.#.#
#.....#...............#S#.....#
###############################
