###############################
#.....................#.#.....#
#.###.###############.#.#.###.#
#.#...#.....#.......#.#...#...#
###.###.###.#.#####.#.#####.#.#
#...#.....#...#.....#.....#.#.#
#.#.#.#####.###.#########.#.###
#.#.#.#...#.#...#.....#.#.#...#
#.###.#.#.#.#.#####.#.#.#.###.#
#.....#.#.#.#.#.....#...#.....#
#######.#.###.###.###########.#
#...#...#.....#...#.........#.#
#.#.#.#########.###.#####.###.#
#.#.#...#.....#...#.....#...#.#
#.#####.#.###.###.#.#######.#.#
#.#S....#.#...#...#.#.......#.#
#.#######.###.#.###.#.#####.#.#
#.....#.....#.#.....#.#.....#.#
#.#.###.###.#.#######.#.#####.#
#.#...#...#.#...#...#.#.....#.#
#####.#.###.###.#.#.#.#####.#.#
#.....#.#...#...#.#.#.#.....#.#
#.###.#.#.###.###.#.#.#.#####.#
#...#.#.#...#.....#...#.....#.#
###.###.###.#############.###.#
#...#...#...#.......#...#.#...#
#.#.#.###.###.#####.#.#.###.###
#.#.#.#.#...#.#...#E..#.....#.#
#.###.#.###.#.###.###########.#
#.........#...................#
###############################
